"AC Name","State","male 18-19","female 18-19","others 18-19","total 18-19","gender roll ratio","electors with EPIC","EPIC percent","electors with photo","PER Percent","male above 18","female above 18","others above 18","total above 18"
"Andaman & Nicobar Islands","Andaman & Nicobar Islands",1529,1370,0,2899,"891 ","254093 ",98.00,"254093 ",98.00,136356,121500,0,257856
"Sirpur","Andhra Pradesh",3925,2483,3,6411,"978 ","187963 ",100.00,"187963 ",100.00,94996,92940,27,187963
"Chennur","Andhra Pradesh",3245,1993,2,5240,"944 ","170249 ",100.00,"170249 ",100.00,87549,82688,12,170249
"Bellampalli","Andhra Pradesh",2883,1926,3,4812,"966 ","156920 ",100.00,"156920 ",100.00,79823,77083,14,156920
"Mancherial","Andhra Pradesh",4005,2929,7,6941,"947 ","230013 ",100.00,"230013 ",100.00,118103,111885,25,230013
"Asifabad","Andhra Pradesh",4837,3431,4,8272,"994 ","188444 ",100.00,"188444 ",100.00,94503,93907,34,188444
"Khanapur","Andhra Pradesh",4117,2702,2,6821,"1017 ","183298 ",100.00,"183298 ",100.00,90846,92430,22,183298
"Adilabad","Andhra Pradesh",4075,2786,1,6862,"968 ","215236 ",100.00,"215236 ",100.00,109367,105856,13,215236
"Boath","Andhra Pradesh",4094,2901,3,6998,"1011 ","174138 ",100.00,"174138 ",100.00,86601,87523,14,174138
"Nirmal","Andhra Pradesh",4287,2904,2,7193,"1113 ","205983 ",100.00,"205983 ",100.00,97472,108499,12,205983
"Mudhole","Andhra Pradesh",4856,2945,1,7802,"1037 ","206023 ",100.00,"206023 ",100.00,101124,104889,10,206023
"Armur","Andhra Pradesh",3191,1660,0,4851,"1119 ","178786 ",100.00,"178786 ",100.00,84382,94401,3,178786
"Bodhan","Andhra Pradesh",3259,1847,2,5108,"1052 ","197389 ",100.00,"197389 ",100.00,96210,101167,12,197389
"Jukkal","Andhra Pradesh",2506,1299,3,3808,"1013 ","180628 ",100.00,"180628 ",100.00,89711,90906,11,180628
"Banswada","Andhra Pradesh",2568,1367,1,3936,"1053 ","175968 ",100.00,"175968 ",100.00,85713,90246,9,175968
"Yellareddy","Andhra Pradesh",2919,1414,0,4333,"1075 ","196018 ",100.00,"196018 ",100.00,94450,101562,6,196018
"Kamareddy","Andhra Pradesh",2953,1420,1,4374,"1033 ","215558 ",100.00,"215558 ",100.00,106042,109507,9,215558
"Nizamabad (Urban)","Andhra Pradesh",3160,2346,1,5507,"991 ","241562 ",100.00,"241562 ",100.00,121313,120232,17,241562
"Nizamabad (Rural)","Andhra Pradesh",3952,2084,0,6036,"1133 ","224396 ",100.00,"224396 ",100.00,105218,119168,10,224396
"Balkonda","Andhra Pradesh",3287,1726,0,5013,"1167 ","194462 ",100.00,"194462 ",100.00,89732,104722,8,194462
"Koratla","Andhra Pradesh",3261,1660,0,4921,"1032 ","214367 ",100.00,"214367 ",100.00,105515,108847,5,214367
"Jagtial","Andhra Pradesh",3175,2140,2,5317,"1019 ","200502 ",100.00,"200502 ",100.00,99291,101202,9,200502
"Dharmapuri","Andhra Pradesh",3220,1615,1,4836,"1031 ","193966 ",100.00,"193966 ",100.00,95492,98467,7,193966
"Ramagundam","Andhra Pradesh",3110,2311,1,5422,"902 ","209875 ",100.00,"209875 ",100.00,110342,99518,15,209875
"Manthani","Andhra Pradesh",3981,2620,4,6605,"986 ","203387 ",100.00,"203387 ",100.00,102424,100953,10,203387
"Peddapalle","Andhra Pradesh",2898,1694,1,4593,"976 ","214771 ",100.00,"214771 ",100.00,108686,106075,10,214771
"Karimnagar","Andhra Pradesh",5657,4077,4,9738,"936 ","307299 ",100.00,"307299 ",100.00,158742,148536,21,307299
"Choppadandi","Andhra Pradesh",3565,2132,1,5698,"1017 ","199703 ",100.00,"199703 ",100.00,99020,100676,7,199703
"Vemulawada","Andhra Pradesh",2656,1376,0,4032,"1039 ","181512 ",100.00,"181512 ",100.00,89035,92473,4,181512
"Sircilla","Andhra Pradesh",3365,2111,1,5477,"1011 ","208570 ",100.00,"208570 ",100.00,103712,104844,14,208570
"Manakondur","Andhra Pradesh",3220,1898,0,5118,"1000 ","191724 ",100.00,"191724 ",100.00,95866,95852,6,191724
"Huzurabad","Andhra Pradesh",3187,1912,2,5101,"987 ","205182 ",100.00,"205182 ",100.00,103258,101914,10,205182
"Husnabad","Andhra Pradesh",3291,1947,0,5238,"1010 ","212797 ",100.00,"212797 ",100.00,105893,106899,5,212797
"Siddipet","Andhra Pradesh",4579,2484,2,7065,"1004 ","197895 ",100.00,"197895 ",100.00,98732,99151,12,197895
"Medak","Andhra Pradesh",2578,1586,1,4165,"1063 ","199553 ",100.00,"199553 ",100.00,96741,102807,5,199553
"Narayankhed","Andhra Pradesh",3423,1941,2,5366,"974 ","198234 ",100.00,"198234 ",100.00,100432,97789,13,198234
"Andole","Andhra Pradesh",3765,2073,0,5838,"1004 ","223352 ",100.00,"223352 ",100.00,111457,111888,7,223352
"Narsapur","Andhra Pradesh",3979,1961,2,5942,"1033 ","199626 ",100.00,"199626 ",100.00,98186,101433,7,199626
"Zahirabad","Andhra Pradesh",3322,2045,1,5368,"958 ","226878 ",100.00,"226878 ",100.00,115858,111015,5,226878
"Sangareddy","Andhra Pradesh",3534,2095,1,5630,"965 ","203379 ",100.00,"203379 ",100.00,103478,99892,9,203379
"Patancheru","Andhra Pradesh",4663,2946,4,7613,"870 ","276724 ",100.00,"276724 ",100.00,147932,128755,37,276724
"Dubbak","Andhra Pradesh",2740,1386,1,4127,"1022 ","182825 ",100.00,"182825 ",100.00,90411,92407,7,182825
"Gajwel","Andhra Pradesh",4348,1970,1,6319,"991 ","227333 ",100.00,"227333 ",100.00,114191,113135,7,227333
"Medchal","Andhra Pradesh",6795,4082,1,10878,"902 ","403567 ",100.00,"403567 ",100.00,212206,191327,34,403567
"Malkajgiri","Andhra Pradesh",4940,3501,1,8442,"925 ","416337 ",100.00,"416337 ",100.00,216287,200031,19,416337
"Quthbullapur","Andhra Pradesh",10214,6038,3,16255,"772 ","558830 ",100.00,"558830 ",100.00,315254,243488,88,558830
"Kukatpally","Andhra Pradesh",6611,4287,3,10901,"794 ","441181 ",100.00,"441181 ",100.00,245852,195285,44,441181
"Uppal","Andhra Pradesh",9179,5863,6,15048,"844 ","421702 ",100.00,"421702 ",100.00,228641,193028,33,421702
"Ibrahimpatnam","Andhra Pradesh",4288,2511,4,6803,"922 ","221479 ",100.00,"221479 ",100.00,115221,106242,16,221479
"Lal Bahadur Nagar","Andhra Pradesh",9017,6356,5,15378,"865 ","481294 ",100.00,"481294 ",100.00,258080,223147,67,481294
"Maheshwaram","Andhra Pradesh",10110,6055,1,16166,"904 ","379201 ",100.00,"379201 ",100.00,199171,179998,32,379201
"Rajendranagar","Andhra Pradesh",6981,4182,2,11165,"869 ","361463 ",100.00,"361463 ",100.00,193358,168082,23,361463
"Serilingampally","Andhra Pradesh",6746,4292,2,11040,"822 ","531352 ",100.00,"531352 ",100.00,291560,239727,65,531352
"Chevella","Andhra Pradesh",3628,1820,2,5450,"934 ","201685 ",100.00,"201685 ",100.00,104275,97397,13,201685
"PARGI","Andhra Pradesh",4452,2192,1,6645,"959 ","207272 ",100.00,"207272 ",100.00,105815,101453,4,207272
"Vikarabad","Andhra Pradesh",3494,1888,2,5384,"954 ","190425 ",100.00,"190425 ",100.00,97435,92984,6,190425
"Tandur","Andhra Pradesh",2751,1715,0,4466,"1022 ","184932 ",100.00,"184932 ",100.00,91466,93463,3,184932
"Musheerabad","Andhra Pradesh",3919,2631,5,6555,"874 ","260852 ",100.00,"260852 ",100.00,139200,121620,32,260852
"Malakpet","Andhra Pradesh",2692,1704,3,4399,"927 ","231049 ",100.00,"231049 ",100.00,119897,111143,9,231049
"Amberpet","Andhra Pradesh",4252,2974,2,7228,"891 ","245494 ",100.00,"245494 ",100.00,129817,115648,29,245494
"Khairatabad","Andhra Pradesh",4114,2600,2,6716,"870 ","243613 ",100.00,"243613 ",100.00,130255,113346,12,243613
"Jubilee Hills","Andhra Pradesh",4243,2873,1,7117,"835 ","290877 ",100.00,"290877 ",100.00,158527,132328,22,290877
"Sanath Nagar","Andhra Pradesh",2399,1591,1,3991,"873 ","220969 ",100.00,"220969 ",100.00,117960,102997,12,220969
"Nampalli","Andhra Pradesh",3619,2382,0,6001,"885 ","261600 ",100.00,"261600 ",100.00,138795,122792,13,261600
"Karwan","Andhra Pradesh",4057,2367,4,6428,"868 ","249014 ",100.00,"249014 ",100.00,133323,115673,18,249014
"Goshamahal","Andhra Pradesh",5722,3634,2,9358,"883 ","257283 ",100.00,"257283 ",100.00,136628,120619,36,257283
"Charminar","Andhra Pradesh",2541,1442,4,3987,"871 ","172586 ",100.00,"172586 ",100.00,92224,80342,20,172586
"Chandrayangutta","Andhra Pradesh",4536,2588,5,7129,"927 ","234753 ",100.00,"234753 ",100.00,121805,112926,22,234753
"Yakutpura","Andhra Pradesh",3783,2097,0,5880,"917 ","251351 ",100.00,"251351 ",100.00,131140,120203,8,251351
"Bahadurpura","Andhra Pradesh",3883,2317,5,6205,"909 ","221706 ",100.00,"221706 ",100.00,116097,105587,22,221706
"secunderabad","Andhra Pradesh",2524,1861,3,4388,"920 ","226001 ",100.00,"226001 ",100.00,117727,108261,13,226001
"Secunderabad Cantt.","Andhra Pradesh",2435,1617,1,4053,"928 ","231004 ",100.00,"231004 ",100.00,119826,111169,9,231004
"Kodangal","Andhra Pradesh",2998,1718,2,4718,"1029 ","194584 ",100.00,"194584 ",100.00,95909,98659,16,194584
"Narayanpet","Andhra Pradesh",3241,2132,1,5374,"1021 ","195740 ",100.00,"195740 ",100.00,96847,98871,22,195740
"Mahbubnagar","Andhra Pradesh",3264,2388,0,5652,"976 ","212833 ",100.00,"212833 ",100.00,107712,105103,18,212833
"Jadcherla","Andhra Pradesh",2819,1712,2,4533,"974 ","188154 ",100.00,"188154 ",100.00,95317,92825,12,188154
"Devarkadra","Andhra Pradesh",2991,1865,4,4860,"1000 ","205324 ",100.00,"205324 ",100.00,102641,102673,10,205324
"Makthal","Andhra Pradesh",2413,1463,0,3876,"1034 ","205431 ",100.00,"205431 ",100.00,100975,104438,18,205431
"Wanaparthy","Andhra Pradesh",3475,2095,1,5571,"982 ","231691 ",100.00,"231691 ",100.00,116900,114777,14,231691
"Gadwal","Andhra Pradesh",2785,1924,2,4711,"1010 ","207073 ",100.00,"207073 ",100.00,103026,104031,16,207073
"Alampur","Andhra Pradesh",2602,1662,1,4265,"989 ","206886 ",100.00,"206886 ",100.00,103985,102892,9,206886
"Nagarkurnool","Andhra Pradesh",3175,1741,4,4920,"983 ","202218 ",100.00,"202218 ",100.00,101970,100239,9,202218
"Achampet","Andhra Pradesh",2840,1763,2,4605,"986 ","200056 ",100.00,"200056 ",100.00,100713,99326,17,200056
"Kalwakurthy","Andhra Pradesh",3119,1669,1,4789,"951 ","199363 ",100.00,"199363 ",100.00,102187,97164,12,199363
"Shadnagar","Andhra Pradesh",3275,1899,1,5175,"955 ","189299 ",100.00,"189299 ",100.00,96834,92446,19,189299
"Kollapur","Andhra Pradesh",2700,1399,2,4101,"970 ","205019 ",100.00,"205019 ",100.00,104043,100962,14,205019
"Devarakonda","Andhra Pradesh",2936,1689,3,4628,"990 ","207816 ",100.00,"207816 ",100.00,104450,103355,11,207816
"Nagarjuna Sagar","Andhra Pradesh",2331,1462,1,3794,"1003 ","201076 ",100.00,"201076 ",100.00,100380,100693,3,201076
"Miryalguda","Andhra Pradesh",2531,1722,0,4253,"1000 ","200998 ",100.00,"200998 ",100.00,100484,100507,7,200998
"Huzurnagar","Andhra Pradesh",1949,1205,0,3154,"1009 ","215218 ",100.00,"215218 ",100.00,107134,108079,5,215218
"Kodad","Andhra Pradesh",2544,1745,3,4292,"1018 ","209601 ",100.00,"209601 ",100.00,103886,105712,3,209601
"Suryapet","Andhra Pradesh",2358,1675,0,4033,"1010 ","210714 ",100.00,"210714 ",100.00,104816,105892,6,210714
"Nalgonda","Andhra Pradesh",3006,1928,0,4934,"985 ","215422 ",100.00,"215422 ",100.00,108511,106908,3,215422
"Munugode","Andhra Pradesh",2569,1424,0,3993,"960 ","206135 ",100.00,"206135 ",100.00,105160,100975,0,206135
"Bhongir","Andhra Pradesh",2760,1433,0,4193,"964 ","182142 ",100.00,"182142 ",100.00,92736,89403,3,182142
"Nakrekal","Andhra Pradesh",2969,1763,0,4732,"988 ","221304 ",100.00,"221304 ",100.00,111311,109992,1,221304
"Thungathurthy","Andhra Pradesh",2786,1522,2,4310,"991 ","219612 ",100.00,"219612 ",100.00,110319,109284,9,219612
"Alair","Andhra Pradesh",3450,1682,1,5133,"982 ","199203 ",100.00,"199203 ",100.00,100516,98675,12,199203
"Jangoan","Andhra Pradesh",3467,2086,0,5553,"994 ","207028 ",100.00,"207028 ",100.00,103821,103204,3,207028
"Ghanpur (Station)","Andhra Pradesh",3597,1915,0,5512,"998 ","217756 ",100.00,"217756 ",100.00,108996,108755,5,217756
"Palakurthi","Andhra Pradesh",3636,2058,5,5699,"984 ","200775 ",100.00,"200775 ",100.00,101206,99558,11,200775
"Dornakal","Andhra Pradesh",2759,1847,0,4606,"1018 ","187450 ",100.00,"187450 ",100.00,92907,94540,3,187450
"Mahabubabad","Andhra Pradesh",3773,2406,1,6180,"1008 ","211758 ",100.00,"211758 ",100.00,105452,106294,12,211758
"Narsampet","Andhra Pradesh",3657,2087,1,5745,"1009 ","202010 ",100.00,"202010 ",100.00,100569,101432,9,202010
"Parkal","Andhra Pradesh",2702,1770,0,4472,"1022 ","187434 ",100.00,"187434 ",100.00,92714,94716,4,187434
"Warangal West","Andhra Pradesh",3584,2796,2,6382,"974 ","233905 ",100.00,"233905 ",100.00,118460,115435,10,233905
"Warangal East","Andhra Pradesh",2854,2278,3,5135,"1000 ","198928 ",100.00,"198928 ",100.00,99426,99416,86,198928
"Wardhanapet","Andhra Pradesh",3458,2097,0,5555,"991 ","224760 ",100.00,"224760 ",100.00,112910,111846,4,224760
"Bhupalpalle","Andhra Pradesh",4517,2549,1,7067,"983 ","232053 ",100.00,"232053 ",100.00,117031,115001,21,232053
"Mulug","Andhra Pradesh",3590,2217,3,5810,"1007 ","192765 ",100.00,"192765 ",100.00,96039,96709,17,192765
"Pinapaka","Andhra Pradesh",2028,1436,0,3464,"987 ","167676 ",100.00,"167676 ",100.00,84381,83293,2,167676
"Yellandu","Andhra Pradesh",2860,1994,3,4857,"1015 ","184676 ",100.00,"184676 ",100.00,91657,93008,11,184676
"Khammam","Andhra Pradesh",4442,3827,2,8271,"1029 ","254650 ",100.00,"254650 ",100.00,125491,129128,31,254650
"Palair","Andhra Pradesh",2584,1848,8,4440,"1037 ","194037 ",100.00,"194037 ",100.00,95225,98792,20,194037
"Madhira","Andhra Pradesh",2653,1687,0,4340,"1028 ","194322 ",100.00,"194322 ",100.00,95829,98484,9,194322
"Wyra","Andhra Pradesh",2243,1484,0,3727,"1014 ","165166 ",100.00,"165166 ",100.00,82017,83148,1,165166
"Sathupalli","Andhra Pradesh",2961,2124,2,5087,"1007 ","217162 ",100.00,"217162 ",100.00,108192,108963,7,217162
"Kothagudem","Andhra Pradesh",3144,2361,2,5507,"1007 ","218146 ",100.00,"218146 ",100.00,108698,109438,10,218146
"Aswaraopeta","Andhra Pradesh",1636,1191,2,2829,"1033 ","164410 ",100.00,"164410 ",100.00,80878,83523,9,164410
"Bhadrachalam","Andhra Pradesh",2761,2127,1,4889,"1053 ","211437 ",100.00,"211437 ",100.00,102997,108429,11,211437
"Ichchapuram","Andhra Pradesh",5611,4162,0,9773,"1050 ","215700 ",100.00,"215700 ",100.00,105219,110470,11,215700
"Palasa","Andhra Pradesh",4557,3321,2,7880,"1023 ","182249 ",100.00,"182249 ",100.00,90082,92130,37,182249
"Tekkali","Andhra Pradesh",5035,3656,1,8692,"985 ","200471 ",100.00,"200471 ",100.00,100967,99496,8,200471
"Pathapatnam","Andhra Pradesh",4629,3482,2,8113,"988 ","185984 ",100.00,"185984 ",100.00,93526,92445,13,185984
"Srikakulam","Andhra Pradesh",5312,4024,6,9342,"1004 ","219009 ",100.00,"219009 ",100.00,109299,109685,25,219009
"Amadalavalasa","Andhra Pradesh",4170,3055,1,7226,"991 ","169201 ",100.00,"169201 ",100.00,84993,84195,13,169201
"Etcherla","Andhra Pradesh",5009,3711,0,8720,"974 ","206522 ",100.00,"206522 ",100.00,104638,101868,16,206522
"Narasannapeta","Andhra Pradesh",4589,3320,2,7911,"999 ","191470 ",100.00,"191470 ",100.00,95777,95683,10,191470
"Rajam","Andhra Pradesh",4691,3549,1,8241,"970 ","193864 ",100.00,"193864 ",100.00,98419,95430,15,193864
"Palakonda","Andhra Pradesh",3957,2966,0,6923,"1033 ","164027 ",100.00,"164027 ",100.00,80677,83340,10,164027
"Kurupam","Andhra Pradesh",2668,2116,3,4787,"1045 ","173753 ",100.00,"173753 ",100.00,84950,88787,16,173753
"Parvathipuram","Andhra Pradesh",2218,1551,1,3770,"1019 ","170344 ",100.00,"170344 ",100.00,84372,85963,9,170344
"Salur","Andhra Pradesh",1973,1526,1,3500,"1043 ","169585 ",100.00,"169585 ",100.00,83014,86562,9,169585
"Bobbili","Andhra Pradesh",2635,1794,0,4429,"1028 ","207702 ",100.00,"207702 ",100.00,102427,105270,5,207702
"Cheepurupalle","Andhra Pradesh",2427,1690,0,4117,"996 ","186781 ",100.00,"186781 ",100.00,93558,93210,13,186781
"Gajapathinagaram","Andhra Pradesh",2389,1546,1,3936,"1032 ","184929 ",100.00,"184929 ",100.00,91027,93898,4,184929
"Nellimarla","Andhra Pradesh",2177,1453,4,3634,"1009 ","186938 ",100.00,"186938 ",100.00,93035,93886,17,186938
"Vizianagaram","Andhra Pradesh",2109,1513,1,3623,"1036 ","205862 ",100.00,"205862 ",100.00,101115,104719,28,205862
"Srungavarapukota","Andhra Pradesh",2715,2004,2,4721,"1036 ","200126 ",100.00,"200126 ",100.00,98273,101847,6,200126
"Bhimli","Andhra Pradesh",3879,2715,2,6596,"1010 ","269258 ",100.00,"269258 ",100.00,133921,135321,16,269258
"Visakhapatnam East","Andhra Pradesh",3252,2668,0,5920,"985 ","237892 ",100.00,"237892 ",100.00,119862,118027,3,237892
"Visakhapatnam South","Andhra Pradesh",1987,1551,0,3538,"1009 ","189338 ",100.00,"189338 ",100.00,94236,95087,15,189338
"Visakhapatnam  North","Andhra Pradesh",3552,2817,3,6372,"976 ","250661 ",100.00,"250661 ",100.00,126844,123773,44,250661
"Visakhapatnam  West","Andhra Pradesh",2978,2121,2,5101,"924 ","208151 ",100.00,"208151 ",100.00,108184,99951,16,208151
"Gajuwaka","Andhra Pradesh",4687,3760,3,8450,"931 ","274115 ",100.00,"274115 ",100.00,141913,132181,21,274115
"Chodavaram","Andhra Pradesh",2419,1503,0,3922,"1056 ","194076 ",100.00,"194076 ",100.00,94373,99695,8,194076
"V.Madugula","Andhra Pradesh",2026,1344,1,3371,"1042 ","171612 ",100.00,"171612 ",100.00,84056,87552,4,171612
"Araku valley","Andhra Pradesh",3965,3307,1,7273,"1052 ","211391 ",100.00,"211391 ",100.00,103020,108365,6,211391
"Paderu","Andhra Pradesh",3052,2366,4,5422,"1052 ","210772 ",100.00,"210772 ",100.00,102728,108035,9,210772
"Anakapalli","Andhra Pradesh",2174,1403,1,3578,"1054 ","184714 ",100.00,"184714 ",100.00,89937,94773,4,184714
"Pendurthi","Andhra Pradesh",3814,2752,1,6567,"982 ","223003 ",100.00,"223003 ",100.00,112537,110456,10,223003
"ELAMANCHILI","Andhra Pradesh",2226,1563,0,3789,"1039 ","181642 ",100.00,"181642 ",100.00,89076,92562,4,181642
"PAYAKARAOPETA","Andhra Pradesh",2271,1684,2,3957,"1029 ","219278 ",100.00,"219278 ",100.00,108073,111196,9,219278
"Narsipatnam","Andhra Pradesh",2443,1785,1,4229,"1052 ","193679 ",100.00,"193679 ",100.00,94387,99280,12,193679
"Tuni","Andhra Pradesh",2274,1406,0,3680,"996 ","188187 ",100.00,"188187 ",100.00,94301,93877,9,188187
"Prathipadu","Andhra Pradesh",1723,1110,3,2836,"1013 ","179602 ",100.00,"179602 ",100.00,89219,90364,19,179602
"Pithapuram","Andhra Pradesh",2366,1240,1,3607,"969 ","204613 ",100.00,"204613 ",100.00,103927,100679,7,204613
"Kakinada Rural","Andhra Pradesh",2428,1711,1,4140,"986 ","212079 ",100.00,"212079 ",100.00,106778,105296,5,212079
"Peddapuram","Andhra Pradesh",1964,1160,1,3125,"1004 ","184729 ",100.00,"184729 ",100.00,92161,92556,12,184729
"Anaparthy","Andhra Pradesh",2135,1485,0,3620,"1015 ","197878 ",100.00,"197878 ",100.00,98179,99694,5,197878
"Kakinada City","Andhra Pradesh",2036,1584,2,3622,"1034 ","189014 ",100.00,"189014 ",100.00,92924,96062,28,189014
"Ramachandrapuram","Andhra Pradesh",2055,1440,0,3495,"983 ","178130 ",100.00,"178130 ",100.00,89840,88284,6,178130
"Mummidivaram","Andhra Pradesh",2102,1462,0,3564,"972 ","203973 ",100.00,"203973 ",100.00,103408,100559,6,203973
"Amalapuram","Andhra Pradesh",2040,1497,1,3538,"973 ","186000 ",100.00,"186000 ",100.00,94248,91744,8,186000
"Razole","Andhra Pradesh",2057,1572,1,3630,"987 ","169384 ",100.00,"169384 ",100.00,85235,84141,8,169384
"Gannavaram","Andhra Pradesh",2154,1402,2,3558,"955 ","180089 ",100.00,"180089 ",100.00,92121,87953,15,180089
"Kothapeta","Andhra Pradesh",2561,1833,1,4395,"1003 ","216891 ",100.00,"216891 ",100.00,108277,108596,18,216891
"Mandapeta","Andhra Pradesh",2097,1519,2,3618,"1029 ","189614 ",100.00,"189614 ",100.00,93440,96168,6,189614
"Rajanagaram","Andhra Pradesh",1895,1180,2,3077,"1011 ","180482 ",100.00,"180482 ",100.00,89738,90738,6,180482
"Rajahmundry City","Andhra Pradesh",2317,2109,1,4427,"1049 ","203982 ",100.00,"203982 ",100.00,99560,104393,29,203982
"Rajamundry Rural","Andhra Pradesh",2367,1720,0,4087,"1032 ","214495 ",100.00,"214495 ",100.00,105547,108936,12,214495
"Jaggampeta","Andhra Pradesh",1776,1016,0,2792,"1006 ","192415 ",100.00,"192415 ",100.00,95916,96490,9,192415
"Rampachodavaram","Andhra Pradesh",1422,1286,0,2708,"1073 ","147604 ",100.00,"147604 ",100.00,71212,76385,7,147604
"Kovvur","Andhra Pradesh",3532,2852,1,6385,"1037 ","163295 ",100.00,"163295 ",100.00,80181,83109,5,163295
"Nidadavole","Andhra Pradesh",2707,2006,2,4715,"1031 ","185779 ",100.00,"185779 ",100.00,91455,94312,12,185779
"Achanta","Andhra Pradesh",1893,1554,2,3449,"1034 ","155281 ",100.00,"155281 ",100.00,76331,78937,13,155281
"Palacole","Andhra Pradesh",2245,1734,2,3981,"1020 ","163856 ",100.00,"163856 ",100.00,81127,82723,6,163856
"Narasapuram","Andhra Pradesh",2097,1648,2,3747,"1009 ","150577 ",100.00,"150577 ",100.00,74947,75622,8,150577
"Bhimavaram","Andhra Pradesh",3929,3019,3,6951,"1030 ","210128 ",100.00,"210128 ",100.00,103476,106628,24,210128
"Undi","Andhra Pradesh",2337,1798,0,4135,"1012 ","196715 ",100.00,"196715 ",100.00,97780,98923,12,196715
"TANUKU","Andhra Pradesh",4292,3556,0,7848,"1058 ","212260 ",100.00,"212260 ",100.00,103141,109116,3,212260
"Tadepalligudem","Andhra Pradesh",1721,1270,0,2991,"1034 ","181411 ",100.00,"181411 ",100.00,89168,92239,4,181411
"Unguturu","Andhra Pradesh",2561,1820,4,4385,"1010 ","183716 ",100.00,"183716 ",100.00,91410,92286,20,183716
"Denduluru","Andhra Pradesh",2747,1955,1,4703,"1015 ","193626 ",100.00,"193626 ",100.00,96075,97546,5,193626
"Eluru","Andhra Pradesh",3568,2909,0,6477,"1067 ","193979 ",100.00,"193979 ",100.00,93849,100121,9,193979
"Gopalapuram","Andhra Pradesh",2514,1790,1,4305,"993 ","206226 ",100.00,"206226 ",100.00,103449,102767,10,206226
"Polavaram","Andhra Pradesh",2264,1705,0,3969,"1040 ","185536 ",100.00,"185536 ",100.00,90951,94577,8,185536
"Chintalapudi","Andhra Pradesh",3135,2150,1,5286,"1005 ","230026 ",100.00,"230026 ",100.00,114726,115287,13,230026
"Tiruvuru","Andhra Pradesh",2145,1349,2,3496,"992 ","180849 ",100.00,"180849 ",100.00,90799,90038,12,180849
"Nuzvid","Andhra Pradesh",2186,1391,3,3580,"989 ","209192 ",100.00,"209192 ",100.00,105161,104011,20,209192
"Gannavaram","Andhra Pradesh",3856,3007,4,6867,"1029 ","221540 ",100.00,"221540 ",100.00,109179,112343,18,221540
"Gudivada","Andhra Pradesh",2210,1754,1,3965,"1039 ","189459 ",100.00,"189459 ",100.00,92896,96554,9,189459
"Kaikalur","Andhra Pradesh",2697,1818,2,4517,"1002 ","186025 ",100.00,"186025 ",100.00,92926,93087,12,186025
"Pedana","Andhra Pradesh",1768,1053,0,2821,"1005 ","153037 ",100.00,"153037 ",100.00,76311,76720,6,153037
"Machilipatnam","Andhra Pradesh",1931,1384,0,3315,"1036 ","171433 ",100.00,"171433 ",100.00,84195,87235,3,171433
"Avanigadda","Andhra Pradesh",2405,1608,7,4020,"1010 ","193390 ",100.00,"193390 ",100.00,96225,97145,20,193390
"Pamarru","Andhra Pradesh",2085,1492,1,3578,"1022 ","168964 ",100.00,"168964 ",100.00,83559,85393,12,168964
"Penamaluru","Andhra Pradesh",3058,2370,0,5428,"1023 ","226470 ",100.00,"226470 ",100.00,111919,114538,13,226470
"Vijaywada West","Andhra Pradesh",2736,1899,4,4639,"977 ","212584 ",100.00,"212584 ",100.00,107544,105019,21,212584
"Vijayawada central","Andhra Pradesh",2695,2162,1,4858,"1007 ","231184 ",100.00,"231184 ",100.00,115191,115966,27,231184
"Vijayawada East","Andhra Pradesh",3287,2629,8,5924,"987 ","250493 ",100.00,"250493 ",100.00,126037,124435,21,250493
"Mylavaram","Andhra Pradesh",3073,2122,0,5195,"1002 ","225600 ",100.00,"225600 ",100.00,112658,112936,6,225600
"Nandigama","Andhra Pradesh",2171,1421,8,3600,"1024 ","178472 ",100.00,"178472 ",100.00,88159,90289,24,178472
"Jaggayyapeta","Andhra Pradesh",2397,1659,0,4056,"1048 ","177554 ",100.00,"177554 ",100.00,86693,90849,12,177554
"Pedakurapadu","Andhra Pradesh",2263,1566,0,3829,"1013 ","197396 ",100.00,"197396 ",100.00,98081,99309,6,197396
"Tadikonda (SC)","Andhra Pradesh",1951,1325,2,3278,"1027 ","175599 ",100.00,"175599 ",100.00,86632,88960,7,175599
"Mangalagiri","Andhra Pradesh",2902,2113,2,5017,"1025 ","222321 ",100.00,"222321 ",100.00,109776,112531,14,222321
"Ponnur","Andhra Pradesh",2614,1885,0,4499,"1046 ","201189 ",100.00,"201189 ",100.00,98351,102830,8,201189
"Vemuru (SC)","Andhra Pradesh",1672,1154,0,2826,"1034 ","180875 ",100.00,"180875 ",100.00,88908,91963,4,180875
"Repalle","Andhra Pradesh",2094,1333,5,3432,"1019 ","204021 ",100.00,"204021 ",100.00,101022,102981,18,204021
"Tenali","Andhra Pradesh",3081,2598,2,5681,"1047 ","225633 ",100.00,"225633 ",100.00,110207,115405,21,225633
"Bapatla","Andhra Pradesh",1875,1250,1,3126,"1035 ","165401 ",100.00,"165401 ",100.00,81292,84099,10,165401
"Prathipadu (SC)","Andhra Pradesh",2140,1709,1,3850,"1045 ","221936 ",100.00,"221936 ",100.00,108528,113392,16,221936
"Guntur West","Andhra Pradesh",3779,2994,3,6776,"1020 ","243914 ",100.00,"243914 ",100.00,120715,123159,40,243914
"Guntur East","Andhra Pradesh",2563,1975,4,4542,"1019 ","215517 ",100.00,"215517 ",100.00,106736,108764,17,215517
"Chilakaluripet","Andhra Pradesh",2794,2032,4,4830,"1059 ","195328 ",100.00,"195328 ",100.00,94871,100445,12,195328
"Narasaraopet","Andhra Pradesh",2729,1920,0,4649,"1023 ","192166 ",100.00,"192166 ",100.00,95000,97158,8,192166
"Sattenapalli","Andhra Pradesh",2345,1468,2,3815,"1009 ","202780 ",100.00,"202780 ",100.00,100925,101843,12,202780
"Vinukonda","Andhra Pradesh",2545,1710,1,4256,"1009 ","223152 ",100.00,"223152 ",100.00,111082,112056,14,223152
"Gurazala","Andhra Pradesh",3508,2394,1,5903,"1021 ","232955 ",100.00,"232955 ",100.00,115248,117676,31,232955
"Macherla","Andhra Pradesh",3132,2029,4,5165,"1024 ","231811 ",100.00,"231811 ",100.00,114535,117263,13,231811
"Yerragondapalem","Andhra Pradesh",2681,1664,1,4346,"982 ","183527 ",100.00,"183527 ",100.00,92597,90927,3,183527
"Darsi","Andhra Pradesh",3883,2653,2,6538,"993 ","194588 ",100.00,"194588 ",100.00,97640,96941,7,194588
"Parchur","Andhra Pradesh",2406,1486,4,3896,"1039 ","206282 ",100.00,"206282 ",100.00,101141,105123,18,206282
"Addanki","Andhra Pradesh",2433,1663,2,4098,"1026 ","213389 ",100.00,"213389 ",100.00,105328,108053,8,213389
"Chirala","Andhra Pradesh",2548,1797,3,4348,"1052 ","178425 ",100.00,"178425 ",100.00,86965,91448,12,178425
"Santhanuthalapadu","Andhra Pradesh",3204,2285,1,5490,"1015 ","196569 ",100.00,"196569 ",100.00,97534,99025,10,196569
"Ongole","Andhra Pradesh",2410,2004,1,4415,"1043 ","225174 ",100.00,"225174 ",100.00,110212,114942,20,225174
"Kandukur","Andhra Pradesh",1727,1216,1,2944,"1003 ","191543 ",100.00,"191543 ",100.00,95621,95920,3,191544
"Kondapi","Andhra Pradesh",2007,1283,1,3291,"1018 ","208749 ",100.00,"208749 ",100.00,103439,105302,8,208749
"Markapuram","Andhra Pradesh",5356,3464,3,8823,"981 ","189585 ",100.00,"189585 ",100.00,95686,93876,22,189584
"Giddalur","Andhra Pradesh",3057,1752,0,4809,"1007 ","212249 ",100.00,"212249 ",100.00,105749,106488,12,212249
"Kanigiri","Andhra Pradesh",1635,1049,0,2684,"975 ","202101 ",100.00,"202101 ",100.00,102319,99769,13,202101
"Kavali","Andhra Pradesh",1604,1160,0,2764,"1040 ","219107 ",100.00,"219107 ",100.00,107404,111676,27,219107
"Atmakur","Andhra Pradesh",1983,1477,2,3462,"1011 ","203693 ",100.00,"203693 ",100.00,101291,102379,23,203693
"Kovur","Andhra Pradesh",1956,1466,2,3424,"1071 ","234914 ",100.00,"234914 ",100.00,113440,121454,20,234914
"Nellore City","Andhra Pradesh",2585,1798,1,4384,"974 ","229360 ",100.00,"229360 ",100.00,116178,113109,73,229360
"Nellore Rural","Andhra Pradesh",1969,1608,3,3580,"1018 ","238865 ",100.00,"238865 ",100.00,118359,120487,19,238865
"Sarvepalli","Andhra Pradesh",2010,1526,0,3536,"1029 ","199067 ",100.00,"199067 ",100.00,98079,100971,17,199067
"Gudur","Andhra Pradesh",2486,1706,2,4194,"1041 ","210541 ",100.00,"210541 ",100.00,103159,107359,23,210541
"Sullurpeta","Andhra Pradesh",2618,1812,3,4433,"1021 ","218029 ",100.00,"218029 ",100.00,107870,110134,25,218029
"Venkatagiri","Andhra Pradesh",2541,1742,4,4287,"1020 ","208816 ",100.00,"208816 ",100.00,103350,105442,24,208816
"Udayagiri","Andhra Pradesh",2075,1433,0,3508,"996 ","219047 ",100.00,"219047 ",100.00,109753,109286,8,219047
"Badvel","Andhra Pradesh",2816,1774,0,4590,"1002 ","205470 ",100.00,"205470 ",100.00,102648,102819,3,205470
"Rajampet","Andhra Pradesh",2425,1736,0,4161,"1071 ","202633 ",100.00,"202633 ",100.00,97820,104796,17,202633
"Kadapa","Andhra Pradesh",4658,3520,6,8184,"1007 ","255193 ",100.00,"255193 ",100.00,127113,128050,30,255193
"Kodur","Andhra Pradesh",1847,1241,0,3088,"1070 ","171130 ",100.00,"171130 ",100.00,82648,88468,14,171130
"Rayachoti","Andhra Pradesh",2858,1845,2,4705,"1021 ","217006 ",100.00,"217006 ",100.00,107371,109618,17,217006
"Pulivendla","Andhra Pradesh",3669,2771,1,6441,"1026 ","216680 ",100.00,"216680 ",100.00,106936,109734,10,216680
"Kamalapuram","Andhra Pradesh",2636,1836,2,4474,"1026 ","179707 ",100.00,"179707 ",100.00,88709,90976,22,179707
"Jammalamadugu","Andhra Pradesh",3375,2522,1,5898,"1051 ","220680 ",100.00,"220680 ",100.00,107564,113095,21,220680
"Proddatur","Andhra Pradesh",3268,2556,2,5826,"1043 ","218255 ",100.00,"218255 ",100.00,106807,111436,12,218255
"Mydukur","Andhra Pradesh",3021,2125,2,5148,"1036 ","188651 ",100.00,"188651 ",100.00,92636,96008,7,188651
"Allagadda","Andhra Pradesh",2705,1814,5,4524,"1027 ","214948 ",100.00,"214948 ",100.00,106014,108918,16,214948
"Srisailam","Andhra Pradesh",2737,1778,2,4517,"1015 ","177509 ",100.00,"177509 ",100.00,88076,89409,24,177509
"Nandikotkur","Andhra Pradesh",3186,1820,3,5009,"1014 ","198848 ",100.00,"198848 ",100.00,98709,100117,22,198848
"Kurnool","Andhra Pradesh",4401,3613,5,8019,"1005 ","233598 ",100.00,"233598 ",100.00,116467,117102,29,233598
"Panyam","Andhra Pradesh",4434,3067,1,7502,"1001 ","269346 ",100.00,"269346 ",100.00,134593,134726,27,269346
"Nandyal","Andhra Pradesh",3615,2787,3,6405,"1018 ","230811 ",100.00,"230811 ",100.00,114316,116428,67,230811
"Banaganapalle","Andhra Pradesh",2884,1906,2,4792,"1015 ","210782 ",100.00,"210782 ",100.00,104621,106143,18,210782
"Dhone","Andhra Pradesh",2839,2079,3,4921,"1003 ","218744 ",100.00,"218744 ",100.00,109198,109496,50,218744
"Pattikonda","Andhra Pradesh",2784,1680,1,4465,"993 ","194651 ",100.00,"194651 ",100.00,97684,96951,16,194651
"Kodumur","Andhra Pradesh",2747,1798,1,4546,"1000 ","200195 ",100.00,"200195 ",100.00,100102,100082,11,200195
"Yemmiganur","Andhra Pradesh",2752,1861,0,4613,"1023 ","216132 ",100.00,"216132 ",100.00,106845,109265,22,216132
"Mantralayam","Andhra Pradesh",2494,1269,1,3764,"1028 ","176438 ",100.00,"176438 ",100.00,87001,89425,12,176438
"Adoni","Andhra Pradesh",2886,1976,3,4865,"1006 ","206999 ",100.00,"206999 ",100.00,103189,103783,27,206999
"Alur","Andhra Pradesh",2339,1295,1,3635,"990 ","215147 ",100.00,"215147 ",100.00,108101,107030,16,215147
"Rayadurg","Andhra Pradesh",2888,1819,3,4710,"1001 ","219932 ",100.00,"219932 ",100.00,109905,110016,11,219932
"Uravakonda","Andhra Pradesh",2272,1457,2,3731,"981 ","187561 ",100.00,"187561 ",100.00,94661,92887,13,187561
"Guntakal","Andhra Pradesh",2907,2240,1,5148,"981 ","222264 ",100.00,"222264 ",100.00,112178,110051,35,222264
"Tadipatri","Andhra Pradesh",3186,2160,1,5347,"979 ","215085 ",100.00,"215085 ",100.00,108670,106400,15,215085
"Singanamala","Andhra Pradesh",3409,2226,1,5636,"970 ","208287 ",100.00,"208287 ",100.00,105727,102552,8,208287
"Anantapur urban","Andhra Pradesh",3618,2737,2,6357,"969 ","240973 ",100.00,"240973 ",100.00,122379,118562,32,240973
"KALYANDURG","Andhra Pradesh",3145,2025,5,5175,"975 ","189787 ",100.00,"189787 ",100.00,96078,93695,14,189787
"Raptadu","Andhra Pradesh",3478,2374,2,5854,"954 ","207726 ",100.00,"207726 ",100.00,106325,101384,17,207726
"Madakasira","Andhra Pradesh",2231,1409,1,3641,"968 ","186053 ",100.00,"186053 ",100.00,94542,91504,7,186053
"Hindupur","Andhra Pradesh",2447,1640,1,4088,"952 ","199427 ",100.00,"199427 ",100.00,102145,97272,10,199427
"Penukonda","Andhra Pradesh",2313,1345,1,3659,"959 ","195826 ",100.00,"195826 ",100.00,99967,95850,9,195826
"Puttaparthi","Andhra Pradesh",2211,1341,2,3554,"978 ","180957 ",100.00,"180957 ",100.00,91492,89458,7,180957
"Dharmavaram","Andhra Pradesh",2985,2072,2,5059,"969 ","214573 ",100.00,"214573 ",100.00,108954,105600,19,214573
"Kadiri","Andhra Pradesh",2387,1460,0,3847,"994 ","217338 ",100.00,"217338 ",100.00,108985,108348,5,217338
"Thamballapalle","Andhra Pradesh",3130,2012,4,5146,"1008 ","193878 ",100.00,"193878 ",100.00,96556,97295,27,193878
"Pileru","Andhra Pradesh",2258,1480,2,3740,"1016 ","205755 ",100.00,"205755 ",100.00,102047,103689,19,205755
"Madanapalle","Andhra Pradesh",3393,2415,2,5810,"983 ","227123 ",100.00,"227123 ",100.00,114496,112604,22,227122
"Punganur","Andhra Pradesh",3140,2031,1,5172,"1011 ","212725 ",100.00,"212725 ",100.00,105802,106914,13,212729
"Chandragiri","Andhra Pradesh",3283,2329,2,5614,"1016 ","247048 ",100.00,"247048 ",100.00,122535,124488,25,247048
"Tirupati","Andhra Pradesh",3198,2664,1,5863,"962 ","261795 ",100.00,"261795 ",100.00,133447,128316,32,261795
"Srikalahasti","Andhra Pradesh",3891,2856,0,6747,"1044 ","216309 ",100.00,"216309 ",100.00,105814,110484,11,216309
"Satyavedu","Andhra Pradesh",2191,1347,1,3539,"1043 ","189608 ",100.00,"189608 ",100.00,92817,96779,12,189608
"Nagari","Andhra Pradesh",3944,2660,0,6604,"1033 ","177547 ",100.00,"177547 ",100.00,87335,90204,8,177547
"Gangadhara Nellore","Andhra Pradesh",2430,1537,3,3970,"991 ","179284 ",100.00,"179284 ",100.00,90050,89229,5,179284
"Chittoor","Andhra Pradesh",2559,1957,1,4517,"1005 ","173820 ",100.00,"173820 ",100.00,86679,87123,16,173818
"Puthalapattu","Andhra Pradesh",2617,1814,4,4435,"1011 ","194780 ",100.00,"194780 ",100.00,96857,97911,12,194780
"Palamaner","Andhra Pradesh",3099,2028,0,5127,"999 ","229243 ",100.00,"229243 ",100.00,114690,114546,6,229242
"Kuppam","Andhra Pradesh",2602,1533,1,4136,"984 ","191585 ",100.00,"191585 ",100.00,96566,95002,17,191585
"LUMLA","Arunachal Pradesh",163,166,0,329,"1062 ","8120 ",99.00,"8117 ",99.00,3938,4184,0,8122
"TAWANG","Arunachal Pradesh",228,243,0,471,"968 ","9899 ",99.00,"9898 ",99.00,5030,4870,0,9900
"MUKTO","Arunachal Pradesh",174,195,0,369,"1071 ","7120 ",100.00,"7119 ",99.00,3438,3682,0,7120
"DIRANG","Arunachal Pradesh",292,268,0,560,"981 ","12501 ",93.00,"13178 ",98.00,6740,6611,0,13351
"KALAKTANG","Arunachal Pradesh",252,218,0,470,"931 ","8405 ",93.00,"8979 ",99.00,4677,4352,0,9029
"THRIZINO-BURAGAON","Arunachal Pradesh",243,278,0,521,"896 ","13291 ",95.00,"13942 ",99.00,7377,6608,0,13985
"BOMDILA","Arunachal Pradesh",293,340,0,633,"931 ","9588 ",93.00,"10163 ",99.00,5291,4927,0,10218
"BAMENG","Arunachal Pradesh",180,195,0,375,"1156 ","9665 ",99.00,"9717 ",99.00,4529,5234,0,9763
"CHAYANG TAJO","Arunachal Pradesh",251,292,0,543,"1126 ","8963 ",92.00,"9639 ",99.00,4547,5120,0,9667
"SEPPA EAST","Arunachal Pradesh",145,157,0,302,"1084 ","9512 ",88.00,"10675 ",99.00,5130,5562,0,10692
"SEPPA WEST","Arunachal Pradesh",144,184,0,328,"1138 ","6004 ",96.00,"6176 ",99.00,2903,3304,0,6207
"PAKKE KESSANG","Arunachal Pradesh",164,166,0,330,"1147 ","6252 ",90.00,"6880 ",99.00,3215,3689,0,6904
"ITANAGAR","Arunachal Pradesh",838,717,0,1555,"872 ","60984 ",99.00,"60973 ",99.00,32587,28411,0,60998
"DOIMUKH","Arunachal Pradesh",435,486,0,921,"1044 ","23445 ",99.00,"23424 ",99.00,11483,11991,0,23474
"SAGALEE","Arunachal Pradesh",292,297,0,589,"1174 ","12560 ",99.00,"12558 ",99.00,5783,6787,0,12570
"YACHULI","Arunachal Pradesh",224,287,0,511,"1106 ","15082 ",100.00,"15081 ",99.00,7162,7920,0,15082
"ZIRO HAPOLI","Arunachal Pradesh",358,297,0,655,"1075 ","20901 ",100.00,"20897 ",99.00,10074,10828,0,20902
"PALIN","Arunachal Pradesh",161,173,0,334,"1176 ","12995 ",94.00,"13430 ",97.00,6346,7465,0,13811
"NYAPIN","Arunachal Pradesh",168,200,0,368,"1200 ","10853 ",93.00,"11410 ",98.00,5287,6344,0,11631
"TALI","Arunachal Pradesh",428,450,0,878,"1143 ","10382 ",89.00,"11104 ",95.00,5407,6182,0,11589
"KOLORIANG","Arunachal Pradesh",194,219,0,413,"1103 ","10773 ",91.00,"11633 ",98.00,5608,6186,0,11794
"NACHO","Arunachal Pradesh",297,413,0,710,"1185 ","10382 ",99.00,"10434 ",99.00,4786,5669,0,10455
"TALIHA","Arunachal Pradesh",416,470,0,886,"1158 ","9347 ",97.00,"9527 ",99.00,4422,5119,0,9541
"DAPORIJO","Arunachal Pradesh",362,423,0,785,"1085 ","16513 ",97.00,"16895 ",99.00,8121,8810,0,16931
"RAGA","Arunachal Pradesh",423,410,0,833,"1109 ","14879 ",95.00,"15611 ",99.00,7409,8219,0,15628
"DUMPORIJO","Arunachal Pradesh",204,234,0,438,"1078 ","11062 ",95.00,"11500 ",99.00,5554,5988,0,11542
"LIROMOBA","Arunachal Pradesh",217,229,0,446,"1075 ","11585 ",99.00,"11580 ",99.00,5595,6015,0,11610
"LIKABALI","Arunachal Pradesh",247,237,0,484,"990 ","10094 ",100.00,"10086 ",99.00,5073,5021,0,10094
"BASAR","Arunachal Pradesh",208,223,0,431,"1013 ","16245 ",99.00,"16233 ",99.00,8075,8178,0,16253
"ALONG WEST","Arunachal Pradesh",185,207,0,392,"1082 ","11889 ",99.00,"11859 ",99.00,5711,6180,0,11891
"ALONG EAST","Arunachal Pradesh",242,222,0,464,"932 ","12099 ",99.00,"12045 ",99.00,6279,5854,0,12133
"RUMGONG","Arunachal Pradesh",199,243,0,442,"1056 ","10504 ",99.00,"10489 ",99.00,5112,5398,0,10510
"MECHUKHA","Arunachal Pradesh",97,118,0,215,"1131 ","8700 ",94.00,"8964 ",97.00,4336,4905,0,9241
"TUTING YINGKIONG","Arunachal Pradesh",236,233,0,469,"935 ","11317 ",100.00,"11311 ",99.00,5850,5467,0,11317
"PANGIN","Arunachal Pradesh",226,260,0,486,"1005 ","12307 ",98.00,"12225 ",97.00,6253,6283,0,12536
"NARI-KOYU","Arunachal Pradesh",160,169,0,329,"1045 ","6914 ",99.00,"6901 ",99.00,3386,3537,0,6923
"PASIGHAT WEST","Arunachal Pradesh",236,214,0,450,"1071 ","12310 ",100.00,"12308 ",99.00,5943,6367,0,12310
"PASIGHAT EAST","Arunachal Pradesh",371,313,0,684,"983 ","19043 ",99.00,"19024 ",99.00,9607,9448,0,19055
"MEBO","Arunachal Pradesh",195,207,0,402,"1030 ","10066 ",99.00,"10063 ",99.00,4959,5109,0,10068
"MARIYANG-GEKU","Arunachal Pradesh",96,59,0,155,"996 ","10120 ",100.00,"10106 ",99.00,5069,5049,0,10118
"ANINI","Arunachal Pradesh",152,113,0,265,"1025 ","3887 ",99.00,"3888 ",99.00,1928,1976,0,3904
"DAMBUK","Arunachal Pradesh",235,250,0,485,"1034 ","11158 ",100.00,"11158 ",100.00,5487,5671,0,11158
"ROING","Arunachal Pradesh",313,319,0,632,"914 ","12069 ",100.00,"12068 ",99.00,6305,5764,0,12069
"TEZU","Arunachal Pradesh",489,468,0,957,"922 ","16351 ",100.00,"16351 ",100.00,8509,7842,0,16351
"HAYULIANG","Arunachal Pradesh",310,296,0,606,"994 ","10603 ",99.00,"10575 ",99.00,5341,5307,0,10648
"CHOWKHAM","Arunachal Pradesh",239,223,0,462,"863 ","13072 ",99.00,"13072 ",99.00,7024,6065,0,13089
"NAMSAI","Arunachal Pradesh",339,234,0,573,"902 ","20496 ",99.00,"20494 ",99.00,10777,9725,0,20502
"LEKANG","Arunachal Pradesh",415,357,0,772,"922 ","14964 ",99.00,"14964 ",99.00,7818,7206,0,15024
"BORDUMSA - DIYUM","Arunachal Pradesh",269,219,0,488,"858 ","14518 ",96.00,"14424 ",95.00,8134,6981,0,15115
"MIAO","Arunachal Pradesh",291,251,0,542,"955 ","17669 ",99.00,"17650 ",99.00,9079,8668,0,17747
"NAMPONG","Arunachal Pradesh",169,136,0,305,"923 ","8194 ",99.00,"8193 ",99.00,4286,3958,0,8244
"CHANGLANG SOUTH","Arunachal Pradesh",101,84,0,185,"974 ","4805 ",98.00,"4800 ",98.00,2469,2405,0,4874
"CHANGLANG NORTH","Arunachal Pradesh",154,123,0,277,"894 ","9039 ",99.00,"9023 ",99.00,4786,4278,0,9064
"NAMSANG","Arunachal Pradesh",150,106,0,256,"900 ","8852 ",94.00,"9354 ",99.00,4933,4439,0,9372
"KHONSA EAST","Arunachal Pradesh",238,198,0,436,"900 ","9605 ",94.00,"10175 ",99.00,5375,4837,0,10212
"KHONSA WEST","Arunachal Pradesh",278,232,0,510,"1012 ","8790 ",93.00,"9115 ",97.00,4666,4721,0,9387
"BORDURIA BOGAPANI","Arunachal Pradesh",139,135,0,274,"992 ","6649 ",94.00,"7059 ",99.00,3549,3520,0,7069
"KANUBARI","Arunachal Pradesh",320,280,0,600,"948 ","9491 ",91.00,"10210 ",98.00,5343,5063,0,10406
"LONGDING PUMAO","Arunachal Pradesh",274,200,0,474,"1027 ","9343 ",93.00,"10023 ",99.00,4950,5085,0,10035
"PONGCHAO WAKKA","Arunachal Pradesh",216,128,0,344,"976 ","12900 ",92.00,"13504 ",96.00,7076,6905,0,13981
"Ratabari (SC)","Assam",3355,2166,0,5521,"890 ","129672 ",93.00,"134655 ",97.00,73175,65097,0,138272
"Patharkandi","Assam",3844,2736,0,6580,"879 ","136692 ",94.00,"142346 ",98.00,77301,67935,0,145236
"Karimganj North","Assam",4287,2796,0,7083,"915 ","152779 ",94.00,"158950 ",97.00,84776,77578,0,162354
"Karimganj South","Assam",4729,3015,0,7744,"899 ","142156 ",94.00,"147521 ",97.00,79541,71540,0,151081
"Badarpur","Assam",3879,2671,0,6550,"920 ","124846 ",94.00,"128700 ",97.00,68669,63176,0,131845
"Hailakandi","Assam",2844,1795,0,4639,"914 ","123467 ",88.00,"130273 ",93.00,73204,66882,0,140086
"Katlichera","Assam",3337,2159,0,5496,"898 ","134430 ",88.00,"144264 ",95.00,79844,71726,0,151570
"Algapur","Assam",4080,2760,0,6840,"857 ","130079 ",94.00,"136196 ",98.00,74411,63745,0,138156
"Silchar","Assam",4122,3522,0,7644,"967 ","182832 ",88.00,"191420 ",93.00,104519,101098,0,205617
"Sonai","Assam",4513,3435,0,7948,"923 ","140752 ",92.00,"147598 ",97.00,78772,72740,0,151512
"Dholai","Assam",4364,2754,0,7118,"880 ","138865 ",91.00,"146727 ",96.00,80844,71166,0,152010
"Udharbond","Assam",3872,3060,0,6932,"918 ","123989 ",91.00,"130515 ",95.00,70933,65149,0,136082
"Lakhipur","Assam",3806,2910,0,6716,"911 ","125594 ",91.00,"131680 ",95.00,72019,65631,0,137650
"Barkhola","Assam",3787,2903,0,6690,"895 ","114876 ",92.00,"120549 ",97.00,65300,58467,0,123767
"Katigorah","Assam",5271,3627,0,8898,"889 ","141549 ",92.00,"149574 ",98.00,80609,71623,0,152232
"Haflong","Assam",2751,2690,0,5441,"968 ","113187 ",84.00,"118133 ",88.00,68091,65902,0,133993
"Bokajan","Assam",2258,2075,0,4333,"947 ","112899 ",91.00,"118249 ",95.00,63655,60278,0,123933
"Howraghat","Assam",2944,2907,0,5851,"981 ","104088 ",93.00,"109117 ",98.00,55983,54939,0,110922
"Diphu","Assam",3412,3534,0,6946,"958 ","150493 ",93.00,"157112 ",97.00,82413,78987,0,161400
"Baithalangso","Assam",3967,3496,0,7463,"938 ","150273 ",89.00,"155383 ",92.00,86391,81018,0,167409
"Mankachar","Assam",3769,3764,0,7533,"986 ","158228 ",94.00,"165663 ",99.00,84158,83018,0,167176
"Salmara South","Assam",3177,2873,0,6050,"963 ","136431 ",94.00,"141038 ",97.00,73632,70895,0,144527
"Dhubri","Assam",4182,2846,0,7028,"922 ","149515 ",93.00,"154603 ",96.00,83268,76748,0,160016
"Gauripur","Assam",4162,2796,0,6958,"927 ","152831 ",93.00,"158933 ",96.00,85213,79025,0,164238
"Golakganj","Assam",4740,3117,0,7857,"895 ","154559 ",93.00,"161201 ",97.00,87024,77906,0,164930
"Bilasipara West","Assam",3022,2422,0,5444,"957 ","128836 ",93.00,"133105 ",96.00,70334,67277,0,137611
"Bilasipara East","Assam",3939,2895,0,6834,"955 ","161424 ",92.00,"167846 ",96.00,89130,85133,0,174263
"Gossaigaon","Assam",3034,2146,0,5180,"977 ","138509 ",82.00,"144415 ",86.00,84698,82767,0,167465
"Kokrajhar West (ST)","Assam",3167,2308,0,5475,"969 ","133055 ",84.00,"141219 ",89.00,80153,77647,0,157800
"Kokrajhar East","Assam",3516,3153,0,6669,"1021 ","134183 ",84.00,"143261 ",90.00,78691,80378,0,159069
"Sidli","Assam",3490,2903,0,6393,"1005 ","145169 ",83.00,"153785 ",88.00,86440,86880,0,173320
"Bongaigaon","Assam",3082,2480,0,5562,"937 ","137940 ",91.00,"144652 ",96.00,77674,72802,0,150476
"Bijni","Assam",2800,2125,0,4925,"919 ","111535 ",91.00,"118963 ",97.00,63693,58541,0,122234
"Abhayapuri North","Assam",4520,3187,0,7707,"884 ","126685 ",89.00,"137223 ",96.00,75242,66532,0,141774
"Abhayapuri South","Assam",4505,3148,0,7653,"907 ","146978 ",90.00,"157906 ",97.00,85287,77374,0,162661
"Dudhnai","Assam",4855,4285,0,9140,"990 ","154402 ",89.00,"161302 ",93.00,86299,85452,0,171751
"Goalpara East","Assam",5176,4071,0,9247,"968 ","163193 ",94.00,"170128 ",97.00,88236,85374,0,173610
"Goalpara West","Assam",5069,4221,0,9290,"952 ","128680 ",93.00,"133908 ",97.00,70328,66940,0,137268
"Jaleswar","Assam",4066,3169,0,7235,"954 ","118310 ",94.00,"124246 ",99.00,64080,61130,0,125210
"Sorbhog","Assam",4351,2840,0,7191,"892 ","158709 ",90.00,"168004 ",95.00,92728,82693,0,175421
"Bhabanipur","Assam",2963,2016,0,4979,"910 ","111679 ",93.00,"117230 ",98.00,62229,56638,0,118867
"Patacharkuchi","Assam",2321,1624,0,3945,"901 ","115687 ",94.00,"121679 ",98.00,64719,58336,0,123055
"Barpeta","Assam",4283,3006,0,7289,"918 ","157537 ",94.00,"164084 ",98.00,86815,79730,0,166545
"Jania","Assam",4649,3319,0,7968,"900 ","140921 ",90.00,"148259 ",95.00,81939,73713,0,155652
"Baghbar","Assam",4252,3443,0,7695,"919 ","114591 ",92.00,"119771 ",97.00,64282,59058,0,123340
"Sarukhetri","Assam",4245,2815,0,7060,"887 ","151215 ",93.00,"159288 ",98.00,85692,76038,0,161730
"Chenga","Assam",3295,2084,0,5379,"898 ","105312 ",93.00,"110750 ",98.00,59275,53233,0,112508
"Boko","Assam",3651,3217,0,6868,"972 ","171912 ",94.00,"179175 ",98.00,92277,89700,0,181977
"Chaygaon","Assam",2765,2288,0,5053,"958 ","137034 ",93.00,"144039 ",98.00,74692,71525,0,146217
"Palasbari","Assam",1183,1016,0,2199,"923 ","124820 ",97.00,"127543 ",99.00,66859,61689,0,128548
"Jalukbari","Assam",2659,1967,0,4626,"977 ","156394 ",91.00,"164368 ",95.00,86664,84700,0,171364
"Dispur","Assam",5964,4761,0,10725,"936 ","290253 ",85.00,"306954 ",90.00,176083,164745,0,340828
"Gauhati East","Assam",2647,2302,0,4949,"941 ","185792 ",85.00,"191442 ",88.00,111685,105050,0,216735
"Gauhati West","Assam",3524,2783,0,6307,"959 ","212052 ",86.00,"221579 ",90.00,125161,119969,0,245130
"Hajo","Assam",3199,2427,0,5626,"895 ","136439 ",94.00,"143537 ",99.00,76125,68155,0,144280
"Kamalpur","Assam",2709,1811,0,4520,"912 ","131233 ",87.00,"136756 ",90.00,78870,71932,0,150802
"Rangiya","Assam",2713,1856,0,4569,"918 ","140289 ",86.00,"146344 ",90.00,84698,77759,0,162457
"Tamulpur","Assam",2663,1711,0,4374,"877 ","142367 ",90.00,"149923 ",94.00,84243,73912,0,158155
"Nalbari","Assam",2937,1751,0,4688,"846 ","151202 ",90.00,"160463 ",95.00,90975,76976,0,167951
"Barkhetry","Assam",2280,1714,0,3994,"893 ","140380 ",89.00,"148202 ",94.00,82850,74002,0,156852
"Dharmapur","Assam",1470,1073,0,2543,"870 ","112327 ",89.00,"116167 ",92.00,67049,58321,0,125370
"Barama (ST)","Assam",2389,1835,0,4224,"908 ","122660 ",89.00,"131788 ",96.00,71820,65215,0,137035
"Chapaguri (ST)","Assam",2332,1945,0,4277,"956 ","113639 ",87.00,"122170 ",94.00,66077,63160,0,129237
"Panery","Assam",1873,1559,0,3432,"934 ","106199 ",87.00,"113031 ",92.00,62856,58721,0,121577
"Kalaigaon","Assam",2568,2149,0,4717,"934 ","135239 ",93.00,"141089 ",97.00,74655,69710,0,144365
"Sipajhar","Assam",2546,1982,0,4528,"894 ","141781 ",94.00,"146117 ",97.00,78884,70560,0,149444
"Mangaldoi","Assam",3583,3067,0,6650,"934 ","178798 ",95.00,"184941 ",99.00,96411,90037,0,186448
"Dalgaon","Assam",4517,3820,0,8337,"935 ","165018 ",92.00,"173558 ",97.00,92024,86037,0,178061
"Udalguri","Assam",1565,1500,0,3065,"953 ","110508 ",88.00,"116889 ",93.00,64285,61260,0,125545
"Majbat","Assam",1982,1618,0,3600,"905 ","105624 ",87.00,"112542 ",93.00,63368,57356,0,120724
"Dhekiajuli","Assam",2544,1755,0,4299,"898 ","143662 ",87.00,"150674 ",92.00,86068,77310,0,163378
"Barchalla","Assam",2144,1253,0,3397,"893 ","116229 ",86.00,"121594 ",90.00,70767,63181,0,133948
"Tezpur","Assam",2381,1723,0,4104,"962 ","139041 ",92.00,"144052 ",95.00,76824,73914,0,150738
"Rangapara","Assam",1746,1329,0,3075,"948 ","114748 ",87.00,"120501 ",91.00,67549,64064,0,131613
"Sootea","Assam",2195,1772,0,3967,"921 ","131377 ",87.00,"139626 ",92.00,78220,72016,0,150236
"Biswanath","Assam",1854,1527,0,3381,"930 ","124275 ",95.00,"129319 ",99.00,67300,62610,0,129910
"Behali","Assam",1244,1030,0,2274,"909 ","95385 ",94.00,"99343 ",98.00,52809,48005,0,100814
"Gohpur","Assam",2786,2569,0,5355,"921 ","146194 ",89.00,"155096 ",94.00,85471,78704,0,164175
"Jagiroad","Assam",3166,2344,0,5510,"960 ","163436 ",87.00,"170391 ",91.00,95444,91587,0,187031
"Marigaon","Assam",2263,1983,0,4246,"965 ","134440 ",87.00,"140504 ",91.00,78346,75574,0,153920
"Laharighat","Assam",3325,2443,0,5768,"906 ","129311 ",86.00,"135467 ",90.00,78358,70968,0,149326
"Raha","Assam",3795,2396,0,6191,"932 ","153611 ",87.00,"161450 ",92.00,90542,84393,0,174935
"Dhing","Assam",4342,3062,0,7404,"904 ","157766 ",92.00,"165771 ",97.00,89403,80829,0,170232
"Batadroba","Assam",2421,1842,0,4263,"924 ","121461 ",91.00,"127114 ",95.00,69194,63910,0,133104
"Rupohihat","Assam",3532,2892,0,6424,"941 ","141079 ",92.00,"147789 ",96.00,78913,74230,0,153143
"Nowgong","Assam",2756,2219,0,4975,"964 ","139898 ",90.00,"147199 ",95.00,78780,75965,0,154745
"Barhampur","Assam",2602,2008,0,4610,"939 ","133297 ",87.00,"139814 ",91.00,78866,74035,0,152901
"Samaguri","Assam",2526,1821,0,4347,"926 ","119413 ",90.00,"124586 ",94.00,68495,63444,0,131939
"Kaliabor","Assam",1584,1141,0,2725,"940 ","102156 ",88.00,"106891 ",92.00,59621,56059,0,115680
"Jamunamukh","Assam",4761,2603,0,7364,"873 ","154017 ",93.00,"163165 ",98.00,88324,77144,0,165468
"Hojai","Assam",4654,2872,0,7526,"893 ","193403 ",93.00,"203511 ",97.00,109813,98040,0,207853
"Lumding","Assam",3683,2329,0,6012,"899 ","154795 ",91.00,"163919 ",96.00,89126,80101,0,169227
"Bokakhat","Assam",1289,1057,0,2346,"944 ","106496 ",93.00,"110932 ",97.00,58534,55271,0,113805
"Sarupathar","Assam",3462,2944,0,6406,"926 ","184249 ",88.00,"193604 ",93.00,108080,100106,0,208186
"Golaghat","Assam",2537,2251,0,4788,"951 ","147882 ",88.00,"155466 ",93.00,85202,81032,0,166234
"Khumtai","Assam",1384,1039,0,2423,"953 ","101304 ",88.00,"105710 ",92.00,58563,55813,0,114376
"Dergaon","Assam",1419,1171,0,2590,"967 ","124856 ",91.00,"129559 ",95.00,69219,66948,0,136167
"Jorhat","Assam",1375,1222,0,2597,"993 ","137861 ",91.00,"142471 ",94.00,75591,75082,0,150673
"Majuli","Assam",2300,2217,0,4517,"920 ","100231 ",92.00,"106427 ",98.00,56299,51790,0,108089
"Titabar","Assam",1352,1208,0,2560,"971 ","115229 ",93.00,"119174 ",96.00,62739,60888,0,123627
"Mariani","Assam",946,855,0,1801,"975 ","93138 ",93.00,"96063 ",96.00,50501,49228,0,99729
"Teok","Assam",1088,749,0,1837,"952 ","102330 ",92.00,"105813 ",95.00,56565,53834,0,110399
"Amguri","Assam",1084,1026,0,2110,"953 ","98200 ",93.00,"101269 ",96.00,53805,51267,0,105072
"Nazira","Assam",2505,2427,0,4932,"919 ","102070 ",91.00,"105895 ",94.00,58388,53659,0,112047
"Mahmara","Assam",1545,1263,0,2808,"907 ","108898 ",97.00,"112100 ",100.00,58777,53323,0,112100
"Sonari","Assam",1749,1469,0,3218,"912 ","134435 ",95.00,"140171 ",99.00,73898,67405,0,141303
"Thowra","Assam",1118,1032,0,2150,"912 ","83580 ",93.00,"86843 ",96.00,46821,42720,0,89541
"Sibsagar","Assam",1620,1383,0,3003,"950 ","120543 ",93.00,"125088 ",96.00,66386,63070,0,129456
"Bihpuria","Assam",2114,1807,0,3921,"946 ","115462 ",89.00,"121451 ",94.00,65929,62391,0,128320
"Naoboicha","Assam",3695,3025,0,6720,"961 ","155856 ",89.00,"166115 ",95.00,88928,85469,0,174397
"Lakhimpur","Assam",2883,2617,0,5500,"946 ","138314 ",90.00,"145772 ",95.00,78489,74215,0,152704
"Dhakuakhana","Assam",2800,2461,0,5261,"948 ","142379 ",87.00,"151362 ",92.00,83867,79491,0,163358
"Dhemaji","Assam",4054,3850,0,7904,"944 ","175954 ",90.00,"185432 ",95.00,99637,94053,0,193690
"Jonai","Assam",4220,3861,0,8081,"945 ","209274 ",86.00,"217959 ",90.00,124237,117410,0,241647
"Moran","Assam",1546,1359,0,2905,"967 ","103635 ",89.00,"107933 ",93.00,58667,56748,0,115415
"Dibrugarh","Assam",1556,1318,0,2874,"950 ","111925 ",90.00,"116983 ",94.00,63591,60422,0,124013
"Lahowal","Assam",1241,1081,0,2322,"969 ","106631 ",90.00,"112867 ",95.00,59831,57999,0,117830
"Duliajan","Assam",1464,1128,0,2592,"948 ","118685 ",88.00,"124013 ",92.00,68882,65303,0,134185
"Tingkhong","Assam",1449,1183,0,2632,"937 ","105718 ",95.00,"110920 ",99.00,57430,53798,0,111228
"Naharkatia","Assam",1500,1255,0,2755,"933 ","103451 ",94.00,"107564 ",98.00,56357,52584,0,108941
"Chabua","Assam",1403,1074,0,2477,"957 ","115608 ",89.00,"120611 ",93.00,65735,62881,0,128616
"Tinsukia","Assam",1777,1282,0,3059,"898 ","119477 ",85.00,"126176 ",90.00,73210,65759,0,138969
"Digboi","Assam",1159,840,0,1999,"936 ","94986 ",88.00,"99522 ",92.00,55658,52068,0,107726
"Margherita","Assam",1679,1361,0,3040,"937 ","133510 ",84.00,"140823 ",88.00,81907,76716,0,158623
"Doom Dooma","Assam",1066,741,0,1807,"951 ","97673 ",84.00,"101849 ",88.00,59020,56138,0,115158
"Sadiya","Assam",2096,1952,0,4048,"942 ","117544 ",80.00,"128074 ",87.00,75358,70988,0,146346
"Valmiki Nagar","Bihar",1947,972,0,2919,"839 ","242987 ",90.00,"267685 ",100.00,145532,122046,2,267580
"Ramnagar (SC)","Bihar",1543,1109,0,2652,"892 ","219007 ",92.00,"236317 ",100.00,124885,111431,1,236317
"Narkatiaganj","Bihar",2671,1876,1,4548,"855 ","206645 ",93.00,"220400 ",100.00,118791,101595,14,220400
"Bagaha","Bihar",4151,2953,1,7105,"854 ","230888 ",90.00,"256067 ",100.00,138102,117954,10,256066
"Lauriya","Bihar",2415,1577,0,3992,"831 ","195386 ",93.00,"208165 ",100.00,113658,94503,4,208165
"Nautan","Bihar",2723,1281,3,4007,"831 ","200377 ",92.00,"215597 ",100.00,117759,97825,13,215597
"Chanpatia","Bihar",2618,1313,1,3932,"840 ","199108 ",89.00,"221589 ",100.00,120408,101171,10,221589
"Bettiah","Bihar",2707,1504,1,4212,"859 ","199226 ",90.00,"220061 ",100.00,118357,101700,4,220061
"Sikta","Bihar",2310,1669,1,3980,"885 ","206009 ",92.00,"221759 ",100.00,117612,104141,6,221759
"Raxaul","Bihar",3830,2203,0,6033,"843 ","222766 ",93.00,"238403 ",100.00,129366,109034,5,238405
"Sugauli","Bihar",3996,2153,2,6151,"856 ","209653 ",88.00,"237630 ",100.00,128028,109595,5,237628
"Narkatia","Bihar",2087,1292,1,3380,"860 ","219374 ",94.00,"232800 ",100.00,125166,107633,1,232800
"Harsidhi (SC)","Bihar",3375,1581,0,4956,"867 ","197242 ",91.00,"215426 ",100.00,115413,100012,1,215426
"Govindganj","Bihar",2782,1566,1,4349,"828 ","204234 ",91.00,"224048 ",100.00,122553,101492,3,224048
"Kesaria","Bihar",2669,1602,0,4271,"843 ","197322 ",90.00,"218880 ",100.00,118753,100124,2,218879
"Kalyanpur","Bihar",2767,1799,3,4569,"849 ","191621 ",89.00,"213334 ",100.00,115365,97961,8,213334
"Pipra","Bihar",5768,4375,4,10147,"855 ","255038 ",90.00,"281438 ",100.00,151708,129716,14,281438
"Madhuban","Bihar",2562,1674,2,4238,"872 ","190809 ",91.00,"209606 ",100.00,111937,97642,27,209606
"Motihari","Bihar",4075,2267,2,6344,"842 ","234744 ",89.00,"263094 ",100.00,142800,120286,6,263092
"Chiraia","Bihar",2867,1412,5,4284,"860 ","220552 ",89.00,"246245 ",100.00,132388,113848,9,246245
"Dhaka","Bihar",3241,2437,4,5682,"894 ","239118 ",91.00,"261979 ",100.00,138318,123650,11,261979
"Sheohar","Bihar",3193,2637,1,5831,"875 ","230774 ",90.00,"256203 ",100.00,136613,119591,5,256209
"Riga","Bihar",4262,4231,2,8495,"881 ","236543 ",88.00,"267545 ",100.00,142246,125281,16,267543
"Bathnaha (SC)","Bihar",3301,3637,4,6942,"910 ","237326 ",89.00,"264300 ",100.00,138385,125901,13,264299
"Parihar","Bihar",4552,5947,4,10503,"911 ","226013 ",84.00,"268169 ",100.00,140316,127837,14,268167
"Sursand","Bihar",3091,3367,1,6459,"904 ","246332 ",91.00,"268836 ",100.00,141195,127635,3,268833
"Bajpatti","Bihar",3044,3170,1,6215,"894 ","243149 ",91.00,"266530 ",100.00,140736,125787,7,266530
"Sitamarhi","Bihar",3408,2386,3,5797,"865 ","220126 ",89.00,"246038 ",100.00,131944,114083,11,246038
"Runnisaidpur","Bihar",2992,2985,1,5978,"878 ","208180 ",86.00,"239803 ",100.00,127711,112085,5,239801
"Belsand","Bihar",2570,2155,0,4725,"879 ","194134 ",88.00,"218990 ",100.00,116544,102444,1,218989
"Harlakhi","Bihar",4830,5267,3,10100,"921 ","219969 ",91.00,"241686 ",100.00,125804,115874,8,241686
"Benipatti","Bihar",4510,4071,3,8584,"881 ","225377 ",88.00,"253860 ",100.00,134966,118877,16,253859
"Khajauli","Bihar",5117,4494,3,9614,"894 ","233081 ",89.00,"260183 ",100.00,137366,122787,14,260167
"Babubarhi","Bihar",3808,3377,5,7190,"900 ","235549 ",90.00,"260450 ",100.00,137039,123397,13,260449
"Bisfi","Bihar",5369,6884,3,12256,"920 ","237694 ",85.00,"277684 ",100.00,144640,133038,5,277683
"Madhubani","Bihar",4201,4495,4,8700,"883 ","266666 ",90.00,"293830 ",100.00,156010,137799,15,293824
"Rajnagar (SC)","Bihar",4346,2788,2,7136,"879 ","238653 ",87.00,"272110 ",100.00,144831,127268,11,272110
"Jhanjharpur","Bihar",3807,3400,1,7208,"898 ","241222 ",88.00,"271231 ",100.00,142925,128301,5,271231
"Phulparas","Bihar",4337,4076,2,8415,"910 ","255896 ",90.00,"281814 ",100.00,147518,134290,6,281814
"Laukaha","Bihar",4557,4270,1,8828,"932 ","259245 ",90.00,"285443 ",100.00,147732,137705,4,285441
"Nirmali","Bihar",2859,2936,0,5795,"927 ","232666 ",94.00,"246003 ",100.00,127640,118361,2,246003
"Pipra","Bihar",2856,2982,0,5838,"935 ","226735 ",94.00,"239810 ",100.00,123953,115857,0,239810
"Supaul","Bihar",4019,3666,1,7686,"920 ","232940 ",94.00,"245715 ",100.00,127942,117762,8,245712
"Triveniganj (SC)","Bihar",3750,4158,1,7909,"926 ","221593 ",92.00,"239006 ",100.00,124123,114880,3,239006
"Chhatapur","Bihar",2875,2139,2,5016,"888 ","225630 ",93.00,"240870 ",100.00,127575,113280,15,240870
"Narpatganj","Bihar",3569,2459,-8,6020,"874 ","233438 ",87.00,"267942 ",100.00,142968,124964,7,267939
"Raniganj (SC)","Bihar",4401,3169,1,7571,"900 ","230918 ",86.00,"265457 ",100.00,139696,125748,13,265457
"Forbesganj","Bihar",5251,4227,1,9479,"884 ","241771 ",86.00,"278986 ",100.00,148108,130873,6,278987
"Araria","Bihar",5588,5059,-1,10646,"877 ","220857 ",85.00,"256966 ",100.00,136921,120040,7,256968
"Jokihat","Bihar",4470,2744,0,7214,"868 ","210045 ",87.00,"240884 ",100.00,128929,111949,5,240883
"Sikti","Bihar",3556,2769,2,6327,"903 ","218357 ",90.00,"242620 ",100.00,127492,115124,4,242620
"Bahadurganj","Bihar",2460,3872,1,6333,"896 ","222839 ",94.00,"236819 ",100.00,124934,111878,6,236818
"Thakurganj","Bihar",2633,3242,0,5875,"909 ","222600 ",93.00,"236956 ",100.00,124110,112842,4,236956
"Kishanganj","Bihar",1656,3944,0,5600,"974 ","228431 ",94.00,"242175 ",100.00,122690,119476,9,242175
"Kochadhaman","Bihar",2754,3610,0,6364,"891 ","195553 ",94.00,"205971 ",100.00,108914,97055,2,205971
"Amour","Bihar",7387,6694,2,14083,"877 ","238596 ",90.00,"263620 ",100.00,140462,123153,4,263619
"Baisi","Bihar",4514,3312,3,7829,"882 ","206917 ",90.00,"228423 ",100.00,121367,107047,9,228423
"Kasba","Bihar",3465,2733,1,6199,"921 ","214589 ",90.00,"236592 ",100.00,123163,113416,9,236588
"Banmankhi (SC)","Bihar",3149,2759,2,5910,"906 ","240285 ",94.00,"254540 ",100.00,133531,121009,4,254544
"Rupauli","Bihar",3410,2738,0,6148,"918 ","248746 ",93.00,"267245 ",99.00,139339,127925,6,267270
"Dhamdaha","Bihar",3727,3692,0,7419,"928 ","243115 ",91.00,"264683 ",100.00,137254,127426,3,264683
"Purnia","Bihar",4100,2919,0,7019,"885 ","237046 ",89.00,"264320 ",100.00,140183,124121,7,264311
"Katihar","Bihar",3084,2172,0,5256,"866 ","209096 ",93.00,"224034 ",100.00,120014,103921,8,223943
"Kadwa","Bihar",3596,3165,0,6761,"886 ","203250 ",90.00,"223754 ",100.00,118637,105113,3,223753
"Balrampur","Bihar",5133,4900,0,10033,"889 ","245268 ",92.00,"266446 ",100.00,141033,125402,11,266446
"Pranpur","Bihar",2977,2645,0,5622,"901 ","214584 ",89.00,"239210 ",99.00,125853,113422,1,239276
"Manihari (ST)","Bihar",3672,3213,-12,6873,"876 ","203600 ",89.00,"227078 ",100.00,121049,106022,7,227078
"Barari","Bihar",2124,1521,-3,3642,"890 ","205406 ",93.00,"220107 ",100.00,116480,103625,2,220107
"Korha (SC)","Bihar",2682,2081,1,4764,"926 ","196423 ",88.00,"223153 ",100.00,115878,107264,3,223145
"Alamnagar","Bihar",2943,4288,1,7232,"915 ","270980 ",93.00,"290187 ",100.00,151517,138663,5,290185
"Bihariganj","Bihar",2629,2967,0,5596,"929 ","252595 ",93.00,"270838 ",100.00,140414,130416,7,270837
"Singheshwar (SC)","Bihar",4836,5930,4,10770,"920 ","246209 ",91.00,"270491 ",100.00,140854,129631,9,270494
"Madhepura","Bihar",4941,5816,3,10760,"913 ","268028 ",93.00,"286973 ",100.00,150015,136947,9,286971
"Sonbarsha (SC)","Bihar",3002,3420,2,6424,"925 ","244203 ",94.00,"257466 ",100.00,133779,123686,5,257470
"Saharsa","Bihar",3707,4362,0,8069,"906 ","300424 ",94.00,"318057 ",100.00,166892,151159,6,318057
"Simri Bakhtiarpur","Bihar",2695,2714,4,5413,"910 ","260750 ",94.00,"275367 ",99.00,144449,131455,26,275930
"Mahishi","Bihar",3212,2151,1,5364,"942 ","237506 ",95.00,"248378 ",100.00,127910,120465,2,248377
"Kusheshwar Asthan (SC)","Bihar",3099,3824,0,6923,"910 ","201464 ",93.00,"214664 ",100.00,112385,102276,0,214661
"Gaura Bauram","Bihar",3351,2981,0,6332,"892 ","201403 ",93.00,"215515 ",99.00,113932,101593,1,215526
"Benipur","Bihar",3391,3716,0,7107,"892 ","238030 ",93.00,"254675 ",100.00,134583,120092,0,254675
"Alinagar","Bihar",3181,2828,0,6009,"899 ","222040 ",92.00,"239416 ",100.00,126043,113370,3,239416
"Darbhanga Rural","Bihar",3015,2089,0,5104,"859 ","228341 ",91.00,"250633 ",100.00,134841,115792,0,250633
"Darbhanga","Bihar",2327,3047,2,5376,"858 ","238927 ",92.00,"257753 ",100.00,138693,119055,6,257754
"Hayaghat","Bihar",2385,2745,5,5135,"879 ","196923 ",93.00,"210763 ",100.00,112180,98573,10,210763
"Bahadurpur","Bihar",2992,3018,1,6011,"860 ","233224 ",92.00,"251547 ",100.00,135232,116313,3,251548
"Keoti","Bihar",3510,2231,2,5743,"850 ","231648 ",92.00,"249270 ",100.00,134771,114494,5,249270
"Jale","Bihar",3792,2704,1,6497,"855 ","246322 ",91.00,"268943 ",100.00,145003,123939,1,268943
"Gaighat","Bihar",4683,3730,1,8414,"878 ","242226 ",89.00,"269661 ",100.00,143548,126099,4,269651
"Aurai","Bihar",3778,2893,0,6671,"859 ","229822 ",89.00,"256567 ",100.00,138008,118557,2,256567
"Minapur","Bihar",2724,1822,0,4546,"878 ","209225 ",90.00,"232116 ",100.00,123583,108521,8,232112
"Bochaha (SC)","Bihar",3139,2266,0,5405,"885 ","211830 ",91.00,"232710 ",100.00,123434,109273,3,232710
"Sakra (SC)","Bihar",3312,2133,0,5445,"889 ","208108 ",92.00,"225874 ",100.00,119553,106319,2,225874
"Kurhani","Bihar",3560,2166,1,5727,"869 ","223088 ",89.00,"250268 ",100.00,133913,116351,4,250268
"Muzaffarpur","Bihar",3310,2198,0,5508,"840 ","237129 ",88.00,"268689 ",100.00,145996,122679,14,268689
"Kanti","Bihar",3775,1782,1,5558,"851 ","222903 ",88.00,"250889 ",100.00,135532,115349,6,250887
"Baruraj","Bihar",3159,1624,0,4783,"855 ","217891 ",91.00,"237800 ",100.00,128214,109583,1,237798
"Paroo","Bihar",2966,2575,0,5541,"885 ","231730 ",89.00,"258791 ",100.00,137307,121477,5,258789
"Sahebganj","Bihar",3352,2952,0,6304,"863 ","228773 ",90.00,"253940 ",100.00,136279,117644,14,253937
"Baikunthpur","Bihar",2252,3375,1,5628,"911 ","247271 ",93.00,"265675 ",100.00,139060,126623,3,265686
"Barauli","Bihar",2555,2318,0,4873,"895 ","213228 ",88.00,"238494 ",99.00,126458,113177,3,239638
"Gopalganj","Bihar",3339,8405,4,11748,"951 ","256055 ",91.00,"278672 ",99.00,142876,135827,5,278708
"Kuchaikote","Bihar",2590,5269,2,7861,"951 ","237500 ",87.00,"270335 ",99.00,138884,132035,11,270930
"Bhorey (SC)","Bihar",2707,3213,0,5920,"924 ","261174 ",89.00,"287864 ",98.00,151869,140393,5,292267
"Hathua","Bihar",2597,4459,1,7057,"957 ","229550 ",89.00,"257416 ",100.00,131555,125860,5,257420
"Siwan","Bihar",3644,2237,1,5882,"847 ","233010 ",89.00,"261586 ",100.00,141603,119976,2,261581
"Ziradei","Bihar",3142,1586,1,4729,"844 ","203274 ",87.00,"232827 ",100.00,126276,106547,4,232827
"Darauli (SC)","Bihar",4286,1952,1,6239,"857 ","229114 ",86.00,"265469 ",100.00,142991,122482,2,265475
"Raghunathpur","Bihar",3004,1735,2,4741,"863 ","221868 ",89.00,"247766 ",100.00,132995,114758,5,247758
"Daraundha","Bihar",3455,3270,0,6725,"895 ","226773 ",84.00,"267067 ",100.00,140923,126138,5,267066
"Barharia","Bihar",3248,1835,1,5084,"857 ","220660 ",87.00,"252024 ",100.00,135748,116270,6,252024
"Goriakothi","Bihar",3334,3599,0,6933,"900 ","246530 ",88.00,"278222 ",100.00,146390,131814,6,278210
"Maharajganj","Bihar",2821,2180,0,5001,"912 ","229161 ",88.00,"259461 ",100.00,135712,123740,2,259454
"Ekma","Bihar",4694,3373,0,8067,"872 ","229395 ",86.00,"264861 ",100.00,141485,123373,2,264860
"Manjhi","Bihar",5479,4290,0,9769,"868 ","230000 ",86.00,"266353 ",100.00,142547,123795,10,266352
"Baniapur","Bihar",4395,3210,2,7607,"854 ","252114 ",89.00,"280659 ",100.00,151351,129302,4,280657
"Taraiya","Bihar",5062,4107,1,9170,"878 ","221411 ",86.00,"256443 ",100.00,136528,119913,2,256443
"Marhaura","Bihar",3290,3108,0,6398,"882 ","202903 ",88.00,"228974 ",100.00,121672,107295,5,228972
"Chapra","Bihar",5218,3100,0,8318,"821 ","242705 ",86.00,"280048 ",99.00,153790,126284,1,280075
"Garkha (SC)","Bihar",5896,3352,2,9250,"836 ","228944 ",86.00,"263618 ",100.00,143595,120010,11,263616
"Amnour","Bihar",4065,3402,0,7467,"864 ","197748 ",86.00,"228583 ",100.00,122652,105921,9,228582
"Parsa","Bihar",5200,4370,0,9570,"874 ","197256 ",84.00,"234719 ",100.00,125228,109490,1,234719
"Sonepur","Bihar",4871,3889,1,8761,"855 ","222045 ",86.00,"256199 ",100.00,138084,118109,4,256197
"Hajipur","Bihar",3801,2030,0,5831,"841 ","244442 ",88.00,"276636 ",100.00,150273,126356,5,276634
"Lalganj","Bihar",2804,1635,0,4439,"850 ","256617 ",89.00,"285395 ",100.00,154246,131144,4,285394
"Vaishali","Bihar",3337,1827,2,5166,"856 ","251608 ",91.00,"276424 ",100.00,148921,127491,11,276423
"Mahua","Bihar",3401,2298,4,5703,"857 ","216308 ",88.00,"244980 ",100.00,131929,113041,8,244978
"Raja Pakar (SC)","Bihar",2571,1482,3,4056,"845 ","202995 ",90.00,"225262 ",99.00,122249,103260,9,225518
"Raghopur","Bihar",3363,1885,0,5248,"832 ","256732 ",88.00,"291668 ",100.00,159199,132468,1,291668
"Mahnar","Bihar",2840,1684,2,4526,"854 ","219472 ",87.00,"249150 ",99.00,134833,115203,16,250052
"Patepur (SC)","Bihar",2594,1512,1,4107,"861 ","228007 ",93.00,"245095 ",100.00,131668,113417,5,245090
"Kalyanpur (SC)","Bihar",3669,2584,0,6253,"866 ","250328 ",91.00,"274278 ",100.00,147007,127268,3,274278
"Warisnagar","Bihar",3752,3189,0,6941,"882 ","238947 ",91.00,"262559 ",100.00,139495,123064,2,262561
"Samastipur","Bihar",2967,2019,0,4986,"849 ","208263 ",90.00,"231273 ",100.00,125103,106169,3,231275
"Ujiarpur","Bihar",2949,2071,2,5022,"874 ","229768 ",92.00,"247123 ",100.00,131847,115271,5,247123
"Morwa","Bihar",3011,2392,1,5404,"871 ","199151 ",89.00,"221958 ",100.00,118619,103339,9,221967
"Sarairanjan","Bihar",2340,1720,0,4060,"876 ","221252 ",94.00,"235258 ",100.00,125377,109881,0,235258
"Mohiuddinnagar","Bihar",2397,1691,0,4088,"852 ","198095 ",91.00,"217398 ",100.00,117384,100013,1,217398
"Bibhutipur","Bihar",2768,2321,3,5092,"882 ","204772 ",91.00,"222782 ",100.00,118365,104411,6,222782
"Rosera (SC)","Bihar",4548,3770,2,8320,"886 ","247515 ",90.00,"274459 ",100.00,145548,128905,6,274459
"Hasanpur","Bihar",3144,2185,1,5330,"882 ","220810 ",91.00,"240948 ",100.00,127994,112950,4,240948
"Cheria Bariarpur","Bihar",3136,2861,0,5997,"904 ","202975 ",92.00,"219215 ",100.00,115147,104051,17,219215
"Bachhwara","Bihar",4364,3645,2,8011,"881 ","228486 ",90.00,"252571 ",99.00,134258,118338,4,252600
"Teghra","Bihar",4158,4470,0,8628,"865 ","229698 ",91.00,"251833 ",100.00,135059,116762,16,251837
"Matihani","Bihar",3866,2712,0,6578,"856 ","262524 ",92.00,"283472 ",100.00,152745,130740,0,283485
"Sahebpur Kamal","Bihar",3318,2796,3,6117,"872 ","202195 ",92.00,"218219 ",100.00,116563,101644,12,218219
"Begusarai","Bihar",3734,2796,0,6530,"857 ","261880 ",91.00,"285021 ",100.00,153504,131511,7,285022
"Bakhri (SC)","Bihar",2380,2129,0,4509,"911 ","204195 ",88.00,"230649 ",99.00,120715,109949,3,230667
"Alauli (SC)","Bihar",3117,3035,3,6155,"910 ","201367 ",94.00,"213175 ",100.00,111625,101547,5,213177
"Khagaria","Bihar",3626,2695,0,6321,"861 ","205305 ",93.00,"218440 ",100.00,117376,101057,6,218439
"Beldaur","Bihar",4766,3462,3,8231,"883 ","239442 ",91.00,"262721 ",100.00,139522,123189,8,262719
"Parbatta","Bihar",5125,3498,0,8623,"853 ","237565 ",90.00,"263863 ",100.00,142391,121468,3,263862
"Bihpur","Bihar",3621,5937,1,9559,"902 ","206774 ",89.00,"229901 ",100.00,120860,109037,4,229901
"Gopalpur","Bihar",4652,6845,17,11514,"902 ","221647 ",92.00,"240426 ",100.00,126372,114029,25,240426
"Pirpainti (SC)","Bihar",3110,4481,2,7593,"895 ","268563 ",93.00,"288392 ",100.00,152152,136237,3,288392
"Kahalgaon","Bihar",2924,5761,1,8686,"922 ","258731 ",90.00,"287171 ",100.00,149440,137725,6,287171
"Bhagalpur","Bihar",2655,2203,-1,4857,"857 ","279426 ",94.00,"297120 ",100.00,159960,137146,13,297119
"Sultanganj","Bihar",4541,5500,6,10047,"893 ","267510 ",93.00,"286756 ",100.00,151490,135250,16,286756
"Nathnagar","Bihar",6435,6887,2,13324,"875 ","263040 ",92.00,"284488 ",100.00,151699,132780,9,284488
"Amarpur","Bihar",2219,2015,0,4234,"873 ","239446 ",94.00,"252908 ",100.00,135007,117894,7,252908
"Dhauraiya (SC)","Bihar",3269,2986,0,6255,"886 ","235454 ",93.00,"250790 ",100.00,133000,117786,3,250789
"Banka","Bihar",2317,2444,0,4761,"902 ","211469 ",95.00,"221517 ",100.00,116460,105056,0,221516
"Katoria (ST)","Bihar",1398,2611,1,4010,"895 ","196226 ",94.00,"208321 ",100.00,109937,98377,2,208316
"Belhar","Bihar",2644,3944,0,6588,"896 ","250086 ",94.00,"264315 ",100.00,139393,124919,2,264314
"Tarapur","Bihar",2878,2204,0,5082,"862 ","250664 ",91.00,"272596 ",100.00,146368,126223,5,272596
"Munger","Bihar",3783,2369,4,6156,"830 ","257904 ",89.00,"287388 ",100.00,157037,130323,28,287388
"Jamalpur","Bihar",2860,1614,0,4474,"817 ","248500 ",91.00,"272343 ",100.00,149846,122494,1,272341
"Suryagarha","Bihar",4831,4003,-5,8829,"856 ","270333 ",90.00,"299748 ",100.00,161469,138269,2,299740
"Lakhisarai","Bihar",5507,3703,-1,9209,"869 ","294386 ",89.00,"329224 ",100.00,176182,153035,6,329223
"Sheikhpura","Bihar",2828,2908,1,5737,"880 ","198495 ",94.00,"209652 ",100.00,111498,98146,8,209652
"Barbigha","Bihar",2514,2513,1,5028,"875 ","177585 ",93.00,"189937 ",100.00,101320,88611,7,189938
"Asthawan","Bihar",3838,3313,2,7153,"865 ","238597 ",92.00,"257254 ",99.00,137957,119313,7,257277
"Biharsharif","Bihar",4238,4920,6,9164,"876 ","311579 ",92.00,"335065 ",100.00,178600,156437,27,335064
"Rajgir (SC)","Bihar",3498,4032,2,7532,"917 ","238849 ",92.00,"258990 ",100.00,135075,123871,5,258951
"Islampur","Bihar",3670,2471,0,6141,"875 ","241198 ",93.00,"258812 ",100.00,137998,120802,11,258811
"Hilsa","Bihar",4304,3633,3,7940,"887 ","247053 ",93.00,"264390 ",100.00,140074,124309,7,264390
"Nalanda","Bihar",3911,3518,3,7432,"889 ","253007 ",93.00,"270628 ",99.00,143307,127342,10,270659
"Harnaut","Bihar",4560,3710,2,8272,"881 ","257027 ",93.00,"274948 ",100.00,146144,128781,12,274937
"Mokama","Bihar",4280,2874,0,7154,"836 ","221086 ",92.00,"239424 ",100.00,130428,108981,5,239414
"Barh","Bihar",4653,2802,0,7455,"830 ","226569 ",92.00,"246240 ",100.00,134523,111709,6,246238
"Bakhtiarpur","Bihar",3784,2040,0,5824,"847 ","216881 ",92.00,"233441 ",100.00,126373,107061,5,233439
"Digha","Bihar",4307,2807,1,7115,"871 ","313917 ",84.00,"364284 ",98.00,198457,172898,17,371372
"Bankipur","Bihar",2714,1963,1,4678,"855 ","258840 ",81.00,"308939 ",97.00,170135,145536,19,315690
"Kumhrar","Bihar",3904,2588,2,6494,"820 ","261880 ",76.00,"336342 ",97.00,188722,154718,25,343465
"Patna Sahib","Bihar",4007,2525,3,6535,"840 ","265819 ",84.00,"316236 ",100.00,171877,144342,14,316233
"Fatuha","Bihar",3341,1877,1,5219,"848 ","210075 ",90.00,"232873 ",100.00,125988,106880,5,232873
"Danapur","Bihar",4401,3113,1,7515,"825 ","235480 ",81.00,"289065 ",100.00,158417,130616,12,289045
"Maner","Bihar",4524,3080,0,7604,"859 ","226998 ",83.00,"273381 ",100.00,147093,126281,7,273381
"Phulwari (SC)","Bihar",3874,2198,1,6073,"836 ","244810 ",86.00,"281457 ",100.00,153255,128179,7,281441
"Masaurhi (SC)","Bihar",5776,5228,5,11009,"894 ","287437 ",93.00,"306115 ",100.00,161629,144458,28,306115
"Paliganj","Bihar",3550,2352,1,5903,"864 ","216034 ",89.00,"242701 ",100.00,130167,112526,9,242702
"Bikram","Bihar",3734,2370,3,6107,"881 ","242306 ",90.00,"268937 ",100.00,142977,125941,5,268923
"Sandesh","Bihar",4004,3718,6,7728,"844 ","216299 ",90.00,"240141 ",100.00,130172,109871,98,240141
"Barhara","Bihar",4397,2212,1,6610,"794 ","232170 ",90.00,"257050 ",100.00,143279,113765,6,257050
"Arrah","Bihar",4101,2268,2,6371,"826 ","235800 ",88.00,"265750 ",100.00,145549,120182,18,265749
"Agiaon (SC)","Bihar",4411,2883,0,7294,"829 ","204577 ",90.00,"224985 ",100.00,123039,101942,4,224985
"Tarari","Bihar",4771,4181,2,8954,"835 ","237704 ",91.00,"258409 ",100.00,140821,117577,11,258409
"Jagdishpur","Bihar",4803,3540,2,8345,"845 ","244569 ",93.00,"262858 ",100.00,142471,120355,18,262844
"Shahpur","Bihar",5387,2475,4,7866,"774 ","238406 ",89.00,"265171 ",100.00,149447,115712,12,265171
"Brahampur","Bihar",4625,2860,0,7485,"851 ","261843 ",90.00,"287884 ",100.00,155518,132361,4,287883
"Buxar","Bihar",4242,3988,0,8230,"879 ","238521 ",92.00,"256656 ",100.00,136572,120084,3,256659
"Dumraon","Bihar",4524,3448,0,7972,"862 ","250113 ",92.00,"271713 ",100.00,145938,125765,5,271708
"Rajpur (SC)","Bihar",4353,3972,0,8325,"902 ","271269 ",94.00,"285849 ",100.00,150306,135543,0,285849
"Ramgarh","Bihar",4174,4747,1,8922,"886 ","215639 ",90.00,"238281 ",99.00,126361,111906,27,238294
"Mohania (SC)","Bihar",4237,3344,5,7586,"863 ","211998 ",90.00,"233920 ",100.00,125520,108377,23,233920
"Bhabua","Bihar",3711,3427,3,7141,"897 ","215614 ",91.00,"235785 ",100.00,124309,111464,14,235787
"Chainpur","Bihar",4269,3728,6,8003,"900 ","246154 ",91.00,"269990 ",100.00,142066,127908,16,269990
"Chenari (SC)","Bihar",3628,2277,-9,5896,"855 ","243136 ",94.00,"256053 ",100.00,138050,118002,1,256053
"Sasaram","Bihar",5246,3165,-33,8378,"856 ","280487 ",91.00,"308065 ",100.00,166002,142075,1,308078
"Kargahar","Bihar",4190,3027,-4,7213,"872 ","264080 ",93.00,"283109 ",100.00,151210,131896,4,283110
"Dinara","Bihar",3056,2673,-5,5724,"873 ","234634 ",92.00,"252654 ",100.00,134867,117785,5,252657
"Nokha","Bihar",3445,2422,1,5868,"858 ","228912 ",90.00,"252369 ",100.00,135804,116559,6,252369
"Dehri","Bihar",3178,2030,0,5208,"855 ","235682 ",92.00,"255576 ",100.00,137754,117817,5,255576
"Karakat","Bihar",3411,3891,-23,7279,"859 ","262468 ",94.00,"277865 ",100.00,149471,128391,4,277866
"Arwal","Bihar",3839,2837,1,6677,"859 ","205116 ",88.00,"231079 ",100.00,124322,106749,9,231080
"Kurtha","Bihar",3295,2131,0,5426,"868 ","193092 ",89.00,"216384 ",100.00,115834,100543,7,216384
"Jahanabad","Bihar",3904,2913,2,6819,"878 ","240261 ",93.00,"257617 ",100.00,137160,120454,2,257616
"Ghosi","Bihar",3509,2650,-2,6157,"908 ","216012 ",92.00,"233537 ",100.00,122382,111146,7,233535
"Makhadumapur (SC)","Bihar",3487,2736,2,6225,"884 ","193445 ",91.00,"210511 ",100.00,111723,98780,3,210506
"Goh","Bihar",4943,3761,3,8707,"880 ","231949 ",87.00,"264371 ",99.00,140691,123835,7,264533
"Obra","Bihar",4988,3035,1,8024,"860 ","239703 ",89.00,"268907 ",99.00,144753,124513,8,269274
"Nabinagar","Bihar",3589,1713,1,5303,"830 ","207696 ",89.00,"232501 ",99.00,127426,105716,9,233151
"Kutumba (SC)","Bihar",3672,1875,1,5548,"824 ","201661 ",89.00,"225471 ",99.00,124164,102353,4,226521
"Aurangabad","Bihar",4701,3150,4,7855,"855 ","226458 ",86.00,"261467 ",100.00,140974,120482,11,261467
"Rafiganj","Bihar",4793,2998,4,7795,"851 ","247407 ",88.00,"279437 ",99.00,151601,128955,11,280567
"Gurua","Bihar",4107,3280,1,7388,"870 ","213937 ",88.00,"242150 ",100.00,129478,112642,7,242127
"Sherghati","Bihar",4443,4436,2,8881,"912 ","211331 ",90.00,"233057 ",100.00,121853,111133,13,232999
"Imamganj (SC)","Bihar",4111,3863,3,7977,"886 ","229455 ",91.00,"250843 ",100.00,132969,117865,9,250843
"Barachatti (SC)","Bihar",4966,5069,3,10038,"918 ","230387 ",90.00,"255221 ",100.00,133030,122162,23,255215
"Bodh Gaya (SC)","Bihar",5001,5795,3,10799,"915 ","246458 ",91.00,"269036 ",100.00,140500,128517,9,269026
"Gaya Town","Bihar",2680,2531,3,5214,"853 ","215454 ",91.00,"235163 ",100.00,126903,108206,33,235142
"Tikari","Bihar",3922,3666,0,7588,"888 ","240089 ",92.00,"260898 ",100.00,138190,122701,2,260893
"Belaganj","Bihar",3279,2746,2,6027,"889 ","215778 ",91.00,"235171 ",100.00,124496,110668,7,235171
"Atri","Bihar",3261,3260,1,6522,"903 ","239101 ",90.00,"265205 ",100.00,139318,125830,6,265154
"Wazirganj","Bihar",3934,3924,5,7863,"905 ","232837 ",90.00,"257060 ",100.00,134946,122102,11,257059
"Rajauli (SC)","Bihar",5505,5874,2,11381,"901 ","246650 ",86.00,"283948 ",100.00,149346,134582,9,283937
"Hisua","Bihar",6276,4430,1,10707,"902 ","284919 ",88.00,"320920 ",100.00,168706,152155,6,320867
"Nawada","Bihar",5007,4342,0,9349,"895 ","268809 ",88.00,"302776 ",100.00,159762,142990,5,302757
"Gobindpur","Bihar",5220,4427,1,9648,"877 ","241414 ",89.00,"269546 ",100.00,143565,125954,8,269527
"Warsaliganj","Bihar",5354,4599,4,9957,"881 ","269742 ",89.00,"303028 ",100.00,161106,141911,13,303030
"Sikandra (SC)","Bihar",3532,3252,2,6786,"879 ","237617 ",92.00,"256645 ",100.00,136592,120047,6,256645
"Jamui","Bihar",3548,2820,0,6368,"858 ","236085 ",92.00,"253952 ",100.00,136675,117276,2,253953
"Jhajha","Bihar",3645,3916,1,7562,"883 ","248351 ",91.00,"271573 ",100.00,144232,127340,4,271576
"Chakai","Bihar",2609,1944,3,4556,"878 ","234892 ",94.00,"248545 ",100.00,132361,116178,6,248545
"CHANDIGARH","Chandigarh",11593,6577,0,18170,"842 ","580418 ",99.00,"580498 ",99.00,315336,265364,0,580700
"Bharatpur-sonhat","Chhattisgarh",4677,4098,0,8775,"978 ","140514 ",93.00,"150236 ",99.00,75949,74311,0,150260
"Manendragarh","Chhattisgarh",2947,2205,0,5152,"895 ","122069 ",93.00,"129475 ",99.00,68561,61357,0,129918
"Baikunthpur","Chhattisgarh",3441,2484,0,5925,"916 ","142871 ",94.00,"148297 ",98.00,78551,71936,0,150487
"Premnagar","Chhattisgarh",3555,3190,0,6745,"979 ","196671 ",99.00,"197964 ",99.00,100073,97926,0,197999
"Bhatgaon","Chhattisgarh",5200,3597,0,8797,"952 ","202914 ",99.00,"203681 ",99.00,104540,99503,0,204043
"Pratappur","Chhattisgarh",4993,4308,0,9301,"963 ","192011 ",99.00,"192522 ",99.00,98390,94727,0,193117
"Ramanujganj","Chhattisgarh",4133,3717,0,7850,"954 ","176028 ",99.00,"176567 ",99.00,90515,86372,0,176887
"Samri","Chhattisgarh",3848,3568,0,7416,"985 ","186909 ",99.00,"187264 ",99.00,94424,93035,0,187459
"Lundra","Chhattisgarh",4114,3571,0,7685,"992 ","167250 ",99.00,"167465 ",99.00,84065,83410,0,167475
"Ambikapur","Chhattisgarh",4993,3897,0,8890,"967 ","206395 ",99.00,"207210 ",99.00,105375,101853,0,207228
"Sitapur","Chhattisgarh",4119,2998,0,7117,"998 ","174938 ",99.00,"175964 ",99.00,88105,87892,0,175997
"Jashpur","Chhattisgarh",5222,4346,0,9568,"977 ","201132 ",97.00,"205687 ",99.00,104876,102436,0,207312
"Kunkuri","Chhattisgarh",4226,3948,0,8174,"1005 ","176692 ",95.00,"184156 ",99.00,92378,92799,0,185177
"Pathalgaon","Chhattisgarh",4249,3630,0,7879,"1010 ","200082 ",98.00,"202448 ",99.00,100824,101811,0,202635
"Lailunga","Chhattisgarh",4699,3298,0,7997,"980 ","174639 ",96.00,"174445 ",96.00,91553,89754,0,181307
"Raigarh","Chhattisgarh",5903,4090,0,9993,"951 ","220483 ",94.00,"225595 ",97.00,118978,113171,0,232149
"Sarangarh","Chhattisgarh",7198,4193,0,11391,"978 ","222036 ",97.00,"227155 ",99.00,115647,113150,0,228797
"Kharsia","Chhattisgarh",5947,3933,0,9880,"980 ","183360 ",95.00,"187482 ",97.00,96643,94696,0,191339
"Dharamjaigarh","Chhattisgarh",5469,4375,0,9844,"1019 ","178115 ",96.00,"179102 ",96.00,91495,93203,0,184698
"Rampur","Chhattisgarh",5049,3482,0,8531,"990 ","191250 ",100.00,"191249 ",99.00,96119,95140,0,191259
"Korba","Chhattisgarh",5277,3794,0,9071,"896 ","220683 ",99.00,"220764 ",99.00,116452,104367,0,220819
"Katghora","Chhattisgarh",5154,3307,0,8461,"901 ","188952 ",99.00,"190567 ",99.00,100268,90326,0,190594
"Pali-tanakhar","Chhattisgarh",5618,4425,0,10043,"974 ","204311 ",99.00,"204424 ",100.00,103572,100854,0,204426
"Marwahi","Chhattisgarh",4628,4205,0,8833,"1006 ","165557 ",95.00,"173634 ",99.00,86622,87141,0,173763
"Kota","Chhattisgarh",5650,4425,0,10075,"973 ","176048 ",93.00,"188023 ",99.00,95349,92770,0,188119
"Lormi","Chhattisgarh",5437,3489,2,8928,"938 ","176512 ",96.00,"182547 ",99.00,94181,88371,12,182564
"Mungeli","Chhattisgarh",6134,3886,5,10025,"933 ","202025 ",95.00,"210607 ",99.00,108961,101674,5,210640
"Takhatpur","Chhattisgarh",7657,4636,0,12293,"923 ","182388 ",91.00,"199907 ",99.00,103978,96017,0,199995
"Bilha","Chhattisgarh",8296,5384,0,13680,"931 ","228616 ",92.00,"248731 ",100.00,128634,119749,0,248383
"Bilaspur","Chhattisgarh",3988,3173,0,7161,"961 ","216500 ",93.00,"232609 ",99.00,118638,114067,0,232705
"Beltara","Chhattisgarh",6242,4034,0,10276,"915 ","177667 ",90.00,"195429 ",99.00,102127,93455,0,195582
"Masturi","Chhattisgarh",8818,5126,0,13944,"931 ","235362 ",93.00,"250936 ",99.00,130406,121350,0,251756
"Akaltara","Chhattisgarh",5971,3485,0,9456,"929 ","186588 ",96.00,"193126 ",99.00,100231,93067,0,193298
"Janjgir-champa","Chhattisgarh",5092,2931,0,8023,"929 ","179094 ",94.00,"184016 ",96.00,98427,91390,0,189817
"Sakti","Chhattisgarh",5542,2928,0,8470,"943 ","183648 ",98.00,"186680 ",99.00,96068,90637,0,186705
"Chandrapur","Chhattisgarh",6332,3553,0,9885,"954 ","195422 ",96.00,"195528 ",96.00,104079,99288,0,203367
"Jaijaipur","Chhattisgarh",6922,3486,0,10408,"935 ","201239 ",94.00,"212588 ",99.00,109907,102808,0,212715
"Pamgarh","Chhattisgarh",4975,2558,0,7533,"920 ","180362 ",99.00,"180933 ",99.00,94481,86913,0,181394
"Saraipali","Chhattisgarh",7438,4190,0,11628,"973 ","175987 ",96.00,"181893 ",99.00,92195,89724,0,181919
"Basna","Chhattisgarh",4495,2629,0,7124,"991 ","186066 ",95.00,"194839 ",99.00,97925,97006,0,194931
"Khallari","Chhattisgarh",8060,5983,0,14043,"1007 ","179836 ",95.00,"187713 ",99.00,93555,94195,0,187750
"Mahasamund","Chhattisgarh",7462,5478,0,12940,"1003 ","171059 ",95.00,"178327 ",99.00,89056,89315,0,178371
"Bilaigarh","Chhattisgarh",9171,5935,0,15106,"967 ","246129 ",94.00,"259194 ",99.00,132961,128607,0,261568
"Kasdol","Chhattisgarh",8871,5140,0,14011,"961 ","293013 ",95.00,"304780 ",99.00,155829,149692,0,305521
"Baloda bazar","Chhattisgarh",6824,4415,0,11239,"970 ","233178 ",98.00,"236989 ",99.00,120382,116713,0,237095
"Bhatapara","Chhattisgarh",6098,4234,0,10332,"981 ","204975 ",95.00,"214937 ",99.00,108911,106789,0,215700
"Dharsiwa","Chhattisgarh",5350,3166,0,8516,"958 ","178261 ",94.00,"186746 ",99.00,96147,92145,0,188292
"Raipur City Gramin","Chhattisgarh",5949,3943,0,9892,"861 ","228711 ",90.00,"236527 ",93.00,136101,117162,0,253263
"Raipur City West","Chhattisgarh",4938,3683,0,8621,"915 ","209699 ",93.00,"224002 ",99.00,117050,107122,0,224172
"Raipur City North","Chhattisgarh",3052,2424,0,5476,"951 ","164947 ",94.00,"165932 ",94.00,89697,85293,0,174990
"Raipur City South","Chhattisgarh",3130,4715,0,7845,"953 ","203589 ",91.00,"211342 ",95.00,113454,108090,0,221544
"Arang","Chhattisgarh",5681,3223,0,8904,"953 ","175839 ",95.00,"183537 ",99.00,94001,89556,0,183557
"Abhanpur","Chhattisgarh",5458,3764,0,9222,"972 ","171575 ",96.00,"178217 ",99.00,90369,87881,0,178250
"Rajim","Chhattisgarh",6383,4537,0,10920,"996 ","186541 ",93.00,"194364 ",97.00,99590,99146,0,198736
"Bindranawagarh","Chhattisgarh",4821,3195,0,8016,"1019 ","186715 ",94.00,"198004 ",99.00,98395,100245,0,198640
"Sihawa","Chhattisgarh",3712,3161,0,6873,"1015 ","169378 ",95.00,"176325 ",99.00,87883,89203,0,177086
"Kurud","Chhattisgarh",6025,4360,0,10385,"981 ","168507 ",95.00,"176713 ",99.00,89264,87530,0,176794
"Dhamtari","Chhattisgarh",5399,4471,0,9870,"1008 ","189405 ",97.00,"193405 ",99.00,96400,97206,0,193606
"Sanjari balod","Chhattisgarh",6852,4493,0,11345,"993 ","188406 ",98.00,"190708 ",99.00,96326,95617,0,191943
"Dondi lahara","Chhattisgarh",4751,3078,0,7829,"1004 ","192632 ",99.00,"193611 ",99.00,96647,97025,0,193672
"Gunderdehi","Chhattisgarh",5560,3145,0,8705,"965 ","200805 ",97.00,"203954 ",98.00,105294,101652,0,206946
"Patan","Chhattisgarh",5128,3093,0,8221,"969 ","171263 ",95.00,"178867 ",99.00,91027,88216,0,179243
"Durg Gramin","Chhattisgarh",5274,3591,0,8865,"950 ","179252 ",93.00,"192531 ",99.00,98799,93876,0,192675
"Durg City","Chhattisgarh",4315,3635,0,7950,"981 ","202450 ",94.00,"213181 ",99.00,107658,105574,0,213232
"Bhilai Nagar","Chhattisgarh",4042,3272,0,7314,"927 ","165188 ",93.00,"176187 ",99.00,91700,85038,0,176738
"Vaishali Nagar","Chhattisgarh",5539,4560,0,10099,"936 ","232281 ",94.00,"244810 ",99.00,126750,118668,0,245418
"Ahiwara","Chhattisgarh",4847,3562,0,8409,"958 ","188567 ",93.00,"200546 ",99.00,103115,98774,0,201889
"Saja","Chhattisgarh",5301,3183,0,8484,"965 ","197369 ",95.00,"205884 ",99.00,104878,101253,0,206131
"Bemetara","Chhattisgarh",5513,3167,0,8680,"973 ","197386 ",96.00,"203505 ",99.00,103172,100381,0,203553
"Navagarh","Chhattisgarh",6141,3647,0,9788,"965 ","213147 ",96.00,"220273 ",99.00,112108,108200,0,220308
"Pandariya","Chhattisgarh",8052,6156,0,14208,"979 ","253849 ",97.00,"259375 ",100.00,131050,128325,0,259375
"Kawardha","Chhattisgarh",8983,7193,0,16176,"1003 ","267661 ",96.00,"275874 ",99.00,137825,138188,0,276013
"Khairagarh","Chhattisgarh",6162,3776,0,9938,"986 ","178915 ",96.00,"184591 ",99.00,93658,92380,0,186038
"Dongargarh","Chhattisgarh",7724,4969,0,12693,"982 ","175461 ",96.00,"180810 ",99.00,91862,90234,0,182096
"Rajnandgaon","Chhattisgarh",5527,4389,0,9916,"1004 ","176496 ",94.00,"186322 ",99.00,93172,93563,0,186735
"Dongargaon","Chhattisgarh",4957,3000,0,7957,"987 ","168386 ",95.00,"172246 ",98.00,88325,87171,0,175496
"Khujji","Chhattisgarh",4937,3088,0,8025,"1004 ","160911 ",96.00,"165513 ",99.00,83245,83588,0,166833
"Mohala-manpur","Chhattisgarh",4900,4414,0,9314,"1017 ","142406 ",96.00,"146838 ",99.00,73224,74501,0,147725
"Antagarh","Chhattisgarh",5900,4731,0,10631,"956 ","145279 ",96.00,"150673 ",99.00,77089,73661,0,150750
"Bhanupratappur","Chhattisgarh",6315,5342,0,11657,"1041 ","177774 ",97.00,"182130 ",99.00,89494,93185,0,182679
"Kanker","Chhattisgarh",5323,4704,0,10027,"1041 ","158902 ",97.00,"163687 ",100.00,80198,83489,0,163687
"Keshkal","Chhattisgarh",6775,6242,0,13017,"1020 ","167598 ",95.00,"175109 ",99.00,86673,88449,0,175122
"Kondagaon","Chhattisgarh",5865,5791,0,11656,"1019 ","145406 ",94.00,"153373 ",99.00,75984,77413,0,153397
"Narainpur","Chhattisgarh",5220,5138,0,10358,"1031 ","150173 ",90.00,"157821 ",95.00,81269,83815,0,165084
"Bastar","Chhattisgarh",4662,4721,0,9383,"1022 ","133702 ",94.00,"140983 ",99.00,69732,71264,0,140996
"Jagdalpur","Chhattisgarh",5340,5346,0,10686,"1034 ","173158 ",95.00,"180448 ",99.00,88707,91753,0,180460
"Chitrakot","Chhattisgarh",5566,6131,0,11697,"1084 ","148302 ",95.00,"154955 ",100.00,74361,80601,0,154962
"Dantewara","Chhattisgarh",5839,5895,0,11734,"1060 ","173513 ",97.00,"174735 ",97.00,86569,91745,0,178314
"Bijapur","Chhattisgarh",4549,3922,0,8471,"1061 ","131851 ",81.00,"131870 ",81.00,78421,83222,0,161643
"Konta","Chhattisgarh",4694,4734,0,9428,"1085 ","123824 ",78.00,"127888 ",80.00,76000,82440,0,158440
"Dadra & Nagar Haveli","Dadra & Nagar Haveli",11560,7095,0,18655,"864 ","188763 ",99.00,"188763 ",99.00,101262,87521,0,188783
"Daman & Diu","Daman & Diu",4860,3918,0,8778,"1021 ","98169 ",96.00,"102260 ",100.00,50595,51665,0,102260
"Mandrem","Goa",293,229,0,522,"981 ","29765 ",99.00,"29910 ",100.00,15101,14809,0,29910
"Pernem","Goa",308,291,0,599,"958 ","29951 ",99.00,"30088 ",100.00,15368,14720,0,30088
"Bicholim","Goa",345,301,0,646,"978 ","23985 ",98.00,"24340 ",100.00,12307,12033,0,24340
"Tivim","Goa",285,242,0,527,"1015 ","23969 ",98.00,"24434 ",100.00,12129,12305,0,24434
"Mapusa","Goa",260,237,0,497,"1006 ","25408 ",97.00,"26110 ",100.00,13018,13092,0,26110
"Siolim","Goa",279,302,0,581,"1030 ","26328 ",98.00,"26714 ",100.00,13161,13553,0,26714
"Saligao","Goa",251,227,0,478,"1009 ","23775 ",98.00,"24057 ",100.00,11975,12082,0,24057
"Calangute","Goa",138,159,0,297,"1028 ","22410 ",98.00,"22742 ",100.00,11215,11527,0,22742
"Porvorim","Goa",216,202,0,418,"1018 ","21938 ",99.00,"22157 ",100.00,10980,11177,0,22157
"Aldona","Goa",212,218,0,430,"1052 ","25382 ",99.00,"25628 ",100.00,12490,13138,0,25628
"Panaji","Goa",229,217,0,446,"1047 ","21237 ",98.00,"21610 ",100.00,10555,11055,0,21610
"Taleigao","Goa",355,317,0,672,"1033 ","25470 ",97.00,"26136 ",100.00,12856,13280,0,26136
"St. Cruz","Goa",249,262,0,511,"1033 ","25345 ",98.00,"25603 ",100.00,12592,13011,0,25603
"St. Andre","Goa",189,198,0,387,"1096 ","20850 ",99.00,"21051 ",100.00,10043,11008,0,21051
"Cumbarjua","Goa",261,216,0,477,"1044 ","23297 ",98.00,"23575 ",100.00,11533,12042,0,23575
"Maem","Goa",378,353,0,731,"986 ","25341 ",99.00,"25577 ",100.00,12878,12699,0,25577
"Sanquelim","Goa",344,315,0,659,"982 ","24302 ",99.00,"24545 ",100.00,12383,12162,0,24545
"Poriem","Goa",498,404,0,902,"968 ","27964 ",98.00,"28416 ",100.00,14441,13975,0,28416
"Valpoi","Goa",415,413,0,828,"984 ","26213 ",98.00,"26608 ",100.00,13412,13196,0,26608
"Priol","Goa",346,355,0,701,"1009 ","27733 ",98.00,"28189 ",100.00,14033,14156,0,28189
"Ponda","Goa",416,374,0,790,"914 ","27343 ",97.00,"27944 ",100.00,14597,13347,0,27944
"Siroda","Goa",367,301,0,668,"1026 ","26244 ",98.00,"26519 ",100.00,13087,13432,0,26519
"Marcaim","Goa",377,308,0,685,"993 ","25305 ",98.00,"25602 ",100.00,12846,12756,0,25602
"Mormugao","Goa",255,214,0,469,"915 ","19485 ",98.00,"19787 ",100.00,10331,9456,0,19787
"Vasco-da-gama","Goa",386,347,0,733,"924 ","29587 ",96.00,"30605 ",100.00,15904,14701,0,30605
"Dabolim","Goa",238,212,0,450,"963 ","19117 ",98.00,"19501 ",100.00,9936,9565,0,19501
"Cortalim","Goa",437,290,0,727,"950 ","26918 ",97.00,"27480 ",100.00,14091,13389,0,27480
"Nuvem","Goa",288,278,0,566,"1097 ","27616 ",99.00,"27788 ",100.00,13250,14538,0,27788
"Curtorim","Goa",283,284,0,567,"1043 ","26427 ",98.00,"26844 ",100.00,13138,13706,0,26844
"Fatorda","Goa",254,225,0,479,"1023 ","27161 ",99.00,"27435 ",100.00,13559,13876,0,27435
"Margao","Goa",250,224,0,474,"985 ","28258 ",98.00,"28593 ",100.00,14403,14190,0,28593
"Benaulim","Goa",260,301,0,561,"1055 ","27793 ",98.00,"28104 ",100.00,13673,14431,0,28104
"Navelim","Goa",273,283,0,556,"997 ","24824 ",98.00,"25235 ",100.00,12639,12596,0,25235
"Cuncolim","Goa",310,300,0,610,"1028 ","26923 ",98.00,"27261 ",100.00,13441,13820,0,27261
"Velim","Goa",296,291,0,587,"1065 ","29494 ",98.00,"29859 ",100.00,14461,15398,0,29859
"Quepem","Goa",371,336,0,707,"984 ","29141 ",99.00,"29398 ",100.00,14815,14583,0,29398
"Curchorem","Goa",321,347,0,668,"1002 ","23999 ",98.00,"24265 ",100.00,12119,12146,0,24265
"Sanvordem","Goa",425,379,0,804,"1017 ","26554 ",98.00,"26879 ",100.00,13325,13554,0,26879
"Sanguem","Goa",361,348,0,709,"1031 ","24260 ",99.00,"24468 ",100.00,12047,12421,0,24468
"Canacona","Goa",439,427,0,866,"999 ","32145 ",99.00,"32247 ",100.00,16132,16115,0,32247
"Abdasa","Gujarat",3577,1991,0,5568,"904 ","200906 ",100.00,"200901 ",100.00,105539,95372,0,200911
"Mandvi","Gujarat",3205,1619,0,4824,"916 ","200830 ",100.00,"200830 ",100.00,104807,96023,0,200830
"Bhuj","Gujarat",2602,1788,0,4390,"936 ","223977 ",99.00,"223609 ",99.00,115976,108557,0,224533
"Anjar","Gujarat",3144,1676,0,4820,"922 ","200183 ",100.00,"200172 ",99.00,104172,96017,0,200189
"Gandhidham","Gujarat",2845,1406,0,4251,"851 ","236247 ",99.00,"236103 ",99.00,127920,108807,1,236728
"Rapar","Gujarat",2622,1193,0,3815,"870 ","195148 ",99.00,"195142 ",99.00,104371,90797,0,195168
"Vav","Gujarat",5018,2717,0,7735,"885 ","237029 ",100.00,"237029 ",100.00,125756,111273,0,237029
"Tharad","Gujarat",4252,1384,0,5636,"882 ","194780 ",100.00,"194780 ",100.00,103487,91293,0,194780
"Dhanera","Gujarat",4297,1521,0,5818,"898 ","213662 ",100.00,"213662 ",100.00,112599,101064,0,213663
"Danta","Gujarat",3004,1793,0,4797,"931 ","199563 ",100.00,"199563 ",100.00,103346,96216,1,199563
"Vadgam","Gujarat",4754,2938,3,7695,"961 ","244695 ",100.00,"244695 ",100.00,124749,119941,6,244696
"Palanpur","Gujarat",3996,2176,0,6172,"921 ","230598 ",100.00,"230598 ",100.00,120041,110554,3,230598
"Deesa","Gujarat",3968,1624,0,5592,"910 ","227947 ",100.00,"227947 ",100.00,119317,108627,3,227947
"Deodar","Gujarat",4239,1471,0,5710,"884 ","196988 ",100.00,"196988 ",100.00,104563,92425,0,196988
"Kankrej","Gujarat",3996,1375,0,5371,"901 ","235010 ",100.00,"235009 ",100.00,123622,111389,1,235012
"Radhanpur","Gujarat",4101,2226,0,6327,"905 ","233817 ",100.00,"233817 ",100.00,122718,111099,0,233817
"Chanasma","Gujarat",4317,2471,0,6788,"923 ","241389 ",100.00,"241389 ",100.00,125520,115869,0,241389
"Patan","Gujarat",4063,2228,0,6291,"919 ","245082 ",100.00,"245082 ",100.00,127705,117377,0,245082
"SIDDHPUR","Gujarat",4310,2426,0,6736,"923 ","221410 ",100.00,"221410 ",100.00,115145,106265,0,221410
"Kheralu","Gujarat",3613,1777,0,5390,"908 ","185710 ",100.00,"185710 ",100.00,97341,88369,0,185710
"Unjha","Gujarat",3489,1707,0,5196,"922 ","201244 ",100.00,"201244 ",100.00,104715,96526,3,201244
"Visnagar","Gujarat",3416,1780,0,5196,"917 ","194987 ",100.00,"194987 ",100.00,101711,93276,0,194987
"Becharaji","Gujarat",3914,1920,0,5834,"926 ","213036 ",100.00,"213036 ",100.00,110599,102428,9,213036
"Kadi","Gujarat",4229,2008,0,6237,"913 ","237211 ",100.00,"237211 ",100.00,123971,113234,6,237211
"Mahesana","Gujarat",3855,1918,0,5773,"914 ","231239 ",100.00,"231239 ",100.00,120785,110454,0,231239
"Vijapur","Gujarat",3392,1931,0,5323,"941 ","197523 ",100.00,"197523 ",100.00,101771,95746,6,197523
"Himatnagar","Gujarat",4027,2423,0,6450,"932 ","229683 ",100.00,"229683 ",100.00,118863,110820,0,229683
"Idar","Gujarat",3874,2375,0,6249,"943 ","240884 ",100.00,"240884 ",100.00,123962,116922,0,240884
"Khedbrahma","Gujarat",3500,2216,0,5716,"945 ","210225 ",100.00,"210225 ",100.00,108076,102149,0,210225
"Bhiloda","Gujarat",4579,2761,0,7340,"933 ","253229 ",100.00,"253229 ",100.00,130971,122257,1,253229
"Modasa","Gujarat",4271,2635,0,6906,"941 ","225583 ",100.00,"225583 ",100.00,116233,109350,0,225583
"Bayad","Gujarat",4077,2237,0,6314,"937 ","207837 ",100.00,"207837 ",100.00,107306,100531,0,207837
"Prantij","Gujarat",4377,2239,0,6616,"925 ","222054 ",100.00,"222054 ",100.00,115344,106710,0,222054
"Dehgam","Gujarat",2852,1351,0,4203,"934 ","181133 ",100.00,"181133 ",100.00,93667,87467,0,181134
"Gandhinagar South","Gujarat",4141,2168,0,6309,"935 ","260211 ",99.00,"260196 ",99.00,134520,125807,0,260327
"Gandhinagar North","Gujarat",2782,1499,0,4281,"928 ","212226 ",99.00,"212217 ",99.00,110097,102152,1,212250
"Mansa","Gujarat",3137,1534,0,4671,"940 ","199578 ",100.00,"199578 ",100.00,102893,96685,0,199578
"Kalol","Gujarat",2690,1367,0,4057,"922 ","199601 ",99.00,"199560 ",99.00,103981,95840,6,199827
"Viramgam","Gujarat",4318,2225,0,6543,"916 ","251163 ",100.00,"251163 ",100.00,131115,120048,0,251163
"Sanand","Gujarat",3748,1598,0,5346,"901 ","218924 ",100.00,"218924 ",100.00,115189,103731,4,218924
"Ghatlodia","Gujarat",3642,2043,0,5685,"943 ","307658 ",100.00,"307658 ",100.00,158351,149307,0,307658
"Vejalpur","Gujarat",3491,2159,0,5650,"938 ","291403 ",100.00,"291403 ",100.00,150393,141009,1,291403
"Vatva","Gujarat",4069,2169,0,6238,"833 ","257650 ",100.00,"257650 ",100.00,140553,117097,0,257650
"Ellisbridge","Gujarat",1673,1159,0,2832,"982 ","230191 ",100.00,"230191 ",100.00,116131,114059,1,230191
"Naranpura","Gujarat",1934,1156,0,3090,"935 ","224555 ",100.00,"224555 ",100.00,116044,108509,2,224555
"Nikol","Gujarat",3134,1668,0,4802,"839 ","228687 ",100.00,"228687 ",100.00,124364,104323,0,228687
"Naroda","Gujarat",2692,1449,1,4142,"869 ","237444 ",100.00,"237444 ",100.00,127028,110412,4,237444
"Thakkarbapa Nagar","Gujarat",2811,1458,0,4269,"878 ","216128 ",100.00,"216128 ",100.00,115077,101050,1,216128
"Bapunagar","Gujarat",2093,1303,0,3396,"880 ","179395 ",100.00,"179395 ",100.00,95402,83992,1,179395
"Amraiwadi","Gujarat",3187,1840,0,5027,"849 ","256774 ",100.00,"256774 ",100.00,138900,117874,0,256774
"Dariapur","Gujarat",1808,1187,0,2995,"931 ","179609 ",100.00,"179609 ",100.00,93037,86572,0,179609
"Jamalpur - Khadia","Gujarat",1930,1271,0,3201,"943 ","187173 ",100.00,"187173 ",100.00,96352,90820,1,187173
"Maninagar","Gujarat",2634,1728,0,4362,"921 ","237240 ",100.00,"237240 ",100.00,123529,113710,1,237240
"Danilimda","Gujarat",2272,1471,0,3743,"902 ","211899 ",100.00,"211899 ",100.00,111425,100473,1,211899
"Sabarmati","Gujarat",2772,1631,0,4403,"897 ","231117 ",100.00,"231117 ",100.00,121852,109264,1,231117
"Asarwa","Gujarat",2128,1204,0,3332,"894 ","192815 ",100.00,"192815 ",100.00,101785,91028,2,192815
"Daskroi","Gujarat",3891,1903,0,5794,"890 ","261375 ",100.00,"261375 ",100.00,138266,123109,0,261375
"Dholka","Gujarat",3179,1538,0,4717,"901 ","210430 ",100.00,"210430 ",100.00,110712,99717,1,210430
"Dhandhuka","Gujarat",3060,1274,0,4334,"854 ","223006 ",100.00,"223006 ",100.00,120277,102729,0,223006
"Dasada","Gujarat",3938,1793,0,5731,"874 ","216323 ",100.00,"216323 ",100.00,115425,100898,0,216323
"Limbdi","Gujarat",4790,1839,0,6629,"879 ","236954 ",100.00,"236954 ",100.00,126083,110870,1,236954
"Wadhwan","Gujarat",3613,1910,0,5523,"910 ","243521 ",100.00,"243521 ",100.00,127512,116008,1,243521
"Chotila","Gujarat",4132,2367,0,6499,"883 ","212402 ",100.00,"212402 ",100.00,112814,99588,0,212402
"Dhrangadhra","Gujarat",4667,2254,0,6921,"885 ","254423 ",100.00,"254423 ",100.00,135001,119421,1,254423
"Morbi","Gujarat",3850,2279,0,6129,"895 ","231802 ",100.00,"231802 ",100.00,122309,109495,0,231804
"Tankara","Gujarat",3828,2484,0,6312,"917 ","206206 ",99.00,"206062 ",99.00,107651,98739,0,206390
"Wankaner","Gujarat",3771,2010,0,5781,"894 ","215636 ",100.00,"215634 ",100.00,113825,101814,0,215639
"Rajkot East","Gujarat",2965,1762,0,4727,"875 ","227309 ",100.00,"227309 ",100.00,121229,106080,0,227309
"Rajkot West","Gujarat",2954,1885,0,4839,"960 ","278475 ",100.00,"278475 ",100.00,142113,136359,3,278475
"Rajkot South","Gujarat",2587,1766,0,4353,"942 ","222045 ",100.00,"222045 ",100.00,114321,107722,2,222045
"Rajkot Rural","Gujarat",3562,1957,0,5519,"879 ","244646 ",100.00,"244646 ",100.00,130235,114411,0,244646
"Jasdan","Gujarat",3712,1752,0,5464,"897 ","211236 ",100.00,"211236 ",100.00,111363,99873,0,211236
"Gondal","Gujarat",3084,1782,0,4866,"924 ","200302 ",100.00,"200302 ",100.00,104120,96180,2,200302
"Jetpur","Gujarat",3307,2097,0,5404,"896 ","240443 ",100.00,"240443 ",100.00,126841,113596,6,240443
"Dhoraji","Gujarat",3135,1688,0,4823,"908 ","239816 ",100.00,"239816 ",100.00,125680,114136,0,239816
"Kalavad S.C.","Gujarat",2805,1579,0,4384,"905 ","202717 ",100.00,"202717 ",100.00,106394,96320,3,202717
"Jamnagar Rural","Gujarat",2890,1615,0,4505,"887 ","199127 ",100.00,"199126 ",100.00,105536,93594,0,199130
"Jamnagar North","Gujarat",2148,1269,0,3417,"916 ","190142 ",100.00,"190142 ",100.00,99225,90918,0,190143
"Jamnagar South","Gujarat",1773,1241,0,3014,"937 ","187736 ",100.00,"187736 ",100.00,96917,90818,3,187738
"Jamjodhpur","Gujarat",2870,1538,0,4408,"890 ","187797 ",100.00,"187795 ",100.00,99363,88434,0,187797
"Khambhalia","Gujarat",3700,1650,0,5350,"907 ","238102 ",100.00,"238102 ",100.00,124825,113267,10,238102
"Dwarka","Gujarat",3287,1397,0,4684,"899 ","233436 ",100.00,"233434 ",100.00,122938,110499,0,233437
"Porbandar","Gujarat",2866,1529,0,4395,"915 ","219016 ",99.00,"218843 ",99.00,114568,104789,0,219357
"Kutiyana","Gujarat",3004,1321,0,4325,"878 ","184078 ",99.00,"183860 ",99.00,98170,86200,0,184370
"Manavadar","Gujarat",3149,1959,0,5108,"895 ","223964 ",99.00,"223808 ",99.00,118293,105861,6,224160
"Junagadh","Gujarat",3151,2035,0,5186,"924 ","230221 ",100.00,"230217 ",99.00,119644,110587,0,230231
"Visavadar","Gujarat",3255,2230,0,5485,"898 ","230412 ",99.00,"230400 ",99.00,121434,108992,0,230426
"Keshod","Gujarat",3269,2007,0,5276,"899 ","208146 ",100.00,"208146 ",100.00,109627,98519,0,208146
"Mangrol","Gujarat",3392,2134,0,5526,"919 ","189903 ",99.00,"189893 ",99.00,99000,90967,0,189967
"Somnath","Gujarat",4525,2945,0,7470,"944 ","216517 ",100.00,"216513 ",100.00,111358,105160,1,216519
"TALALA","Gujarat",3852,2581,0,6433,"925 ","191019 ",99.00,"190866 ",99.00,99371,91949,1,191321
"Kodinar","Gujarat",3942,2517,0,6459,"935 ","193021 ",99.00,"192934 ",99.00,99846,93340,0,193186
"Una","Gujarat",3769,2134,0,5903,"910 ","214444 ",99.00,"213896 ",99.00,113010,102798,1,215809
"Dhari","Gujarat",3237,2174,0,5411,"911 ","201241 ",100.00,"201241 ",100.00,105329,95914,0,201243
"Amreli","Gujarat",3360,2324,0,5684,"932 ","252975 ",100.00,"252975 ",100.00,130943,122033,0,252976
"Lathi","Gujarat",3579,2127,0,5706,"909 ","194443 ",100.00,"194443 ",100.00,101875,92568,0,194443
"Savarkundla","Gujarat",3163,1738,0,4901,"898 ","218552 ",100.00,"218552 ",100.00,115138,103415,1,218554
"Rajula","Gujarat",3747,1792,0,5539,"895 ","220690 ",100.00,"220690 ",100.00,116446,104244,0,220690
"Mahuva","Gujarat",3220,1570,0,4790,"910 ","190009 ",100.00,"190009 ",100.00,99480,90529,0,190009
"Talaja","Gujarat",4112,1997,0,6109,"878 ","202504 ",100.00,"202504 ",100.00,107805,94701,0,202506
"Gariadhar","Gujarat",3143,1566,0,4709,"901 ","191060 ",100.00,"191060 ",100.00,100505,90555,0,191060
"Palitana","Gujarat",4492,2184,0,6676,"905 ","233542 ",100.00,"233542 ",100.00,122592,110950,0,233542
"Bhavnagar Rural","Gujarat",4978,2462,0,7440,"900 ","235076 ",100.00,"235076 ",100.00,123727,111349,0,235076
"Bhavnagar East","Gujarat",2837,1562,0,4399,"950 ","223023 ",100.00,"223023 ",100.00,114353,108669,1,223023
"Bhavnagar West","Gujarat",3204,1669,0,4873,"906 ","217625 ",100.00,"217625 ",100.00,114185,103433,7,217625
"Gadhada","Gujarat",4133,1897,0,6030,"913 ","228206 ",100.00,"228206 ",100.00,119316,108890,0,228206
"Botad","Gujarat",4167,1773,0,5940,"912 ","234140 ",100.00,"234140 ",100.00,122481,111656,3,234140
"Khambhat","Gujarat",2950,1461,0,4411,"890 ","200860 ",100.00,"200860 ",100.00,106285,94573,2,200860
"Borsad","Gujarat",2716,1458,0,4174,"906 ","222014 ",100.00,"222014 ",100.00,116509,105504,1,222014
"Anklav","Gujarat",2815,1338,0,4153,"913 ","186660 ",100.00,"186660 ",100.00,97589,89070,1,186660
"Umreth","Gujarat",2895,1375,0,4270,"920 ","226261 ",100.00,"226260 ",100.00,117868,108393,1,226262
"Anand","Gujarat",3140,1648,1,4789,"947 ","248523 ",99.00,"248497 ",99.00,127745,120919,3,248667
"Petlad","Gujarat",2254,1274,0,3528,"919 ","203730 ",100.00,"203729 ",100.00,106177,97558,0,203735
"Sojitra","Gujarat",2782,1453,0,4235,"902 ","184677 ",100.00,"184670 ",99.00,97095,87585,1,184681
"Matar","Gujarat",3338,1623,1,4962,"913 ","210072 ",100.00,"210072 ",100.00,109801,100269,2,210072
"Nadiad","Gujarat",2065,1227,0,3292,"947 ","226146 ",100.00,"226146 ",100.00,116118,110020,8,226146
"Mehmedabad","Gujarat",3400,1562,0,4962,"932 ","210119 ",100.00,"210119 ",100.00,108785,101334,0,210119
"Mahudha","Gujarat",2368,1187,0,3555,"921 ","205671 ",100.00,"205671 ",100.00,107037,98633,1,205671
"Thasra","Gujarat",3706,1701,0,5407,"901 ","232574 ",100.00,"232574 ",100.00,122325,110247,2,232574
"Kapadvanj","Gujarat",4704,2400,0,7104,"928 ","252277 ",100.00,"252277 ",100.00,130832,121444,1,252277
"Balasinor","Gujarat",3994,2023,0,6017,"905 ","240735 ",100.00,"240735 ",100.00,126368,114367,0,240735
"Lunawada","Gujarat",4649,2774,0,7423,"939 ","244955 ",100.00,"244955 ",100.00,126340,118615,0,244955
"Santrampur","Gujarat",3906,2539,0,6445,"921 ","189692 ",100.00,"189692 ",100.00,98731,90961,0,189692
"Shahera","Gujarat",3660,1896,0,5556,"917 ","214494 ",100.00,"214494 ",100.00,111878,102615,1,214494
"Morva Hadaf","Gujarat",3430,2142,0,5572,"947 ","180973 ",100.00,"180973 ",100.00,92956,88017,0,180973
"Godhra","Gujarat",3564,1948,0,5512,"935 ","228520 ",100.00,"228520 ",100.00,118071,110449,0,228520
"Kalol","Gujarat",3433,1888,0,5321,"911 ","216835 ",100.00,"216835 ",100.00,113490,103345,0,216835
"Halol","Gujarat",3794,1900,0,5694,"902 ","228973 ",100.00,"228973 ",100.00,120365,108607,1,228973
"Fatepura","Gujarat",3326,2629,0,5955,"977 ","190933 ",100.00,"190933 ",100.00,96601,94331,2,190934
"Jhalod","Gujarat",3599,2725,0,6324,"981 ","207342 ",99.00,"207342 ",99.00,104682,102707,0,207389
"Limkheda","Gujarat",3309,2283,0,5592,"1010 ","173307 ",100.00,"173306 ",100.00,86242,87061,5,173308
"Dahod","Gujarat",3186,1993,0,5179,"987 ","214663 ",100.00,"214663 ",100.00,108041,106625,0,214666
"Garbada","Gujarat",2796,2106,0,4902,"1016 ","216069 ",99.00,"216069 ",99.00,107203,108925,0,216128
"Devgadbaria","Gujarat",3564,2237,0,5801,"977 ","206734 ",100.00,"206734 ",100.00,104551,102183,0,206734
"Savli","Gujarat",2787,1185,1,3973,"911 ","196271 ",100.00,"196271 ",100.00,102702,93568,1,196271
"Vaghodia","Gujarat",3416,1355,0,4771,"907 ","206570 ",100.00,"206570 ",100.00,108335,98235,0,206570
"Chhota Udaipur","Gujarat",3465,1817,0,5282,"931 ","219967 ",99.00,"219597 ",99.00,114784,106918,2,221704
"Jetpur","Gujarat",3073,1658,0,4731,"921 ","223316 ",99.00,"222888 ",99.00,116774,107581,0,224355
"Sankheda","Gujarat",2785,1512,0,4297,"932 ","238272 ",99.00,"237926 ",99.00,123996,115523,0,239519
"Dabhoi","Gujarat",2657,1450,0,4107,"932 ","189171 ",100.00,"189171 ",100.00,97922,91249,0,189171
"Vadodara City","Gujarat",2984,1920,0,4904,"930 ","249818 ",100.00,"249818 ",100.00,129434,120384,0,249818
"Sayajigunj","Gujarat",2887,1943,0,4830,"932 ","250290 ",100.00,"250290 ",100.00,129517,120773,0,250290
"Akota","Gujarat",2395,1726,0,4121,"948 ","226964 ",100.00,"226964 ",100.00,116494,110465,5,226964
"Raopura","Gujarat",2617,1710,0,4327,"952 ","250581 ",100.00,"250581 ",100.00,128358,122206,17,250581
"Manjalpur","Gujarat",2612,1607,0,4219,"913 ","210316 ",100.00,"210316 ",100.00,109915,100400,1,210316
"Padra","Gujarat",3373,1690,1,5064,"914 ","204220 ",100.00,"204220 ",100.00,106674,97544,2,204220
"Karjan","Gujarat",2454,1427,0,3881,"920 ","186244 ",100.00,"186244 ",100.00,97018,89218,8,186244
"Nandod","Gujarat",3040,2016,0,5056,"929 ","206874 ",99.00,"206068 ",98.00,108268,100556,0,208824
"Dediyapada","Gujarat",4101,3424,0,7525,"989 ","179469 ",99.00,"179393 ",99.00,90546,89516,0,180062
"Jambusar","Gujarat",3102,1682,1,4785,"897 ","207416 ",100.00,"207416 ",100.00,109317,98092,7,207416
"Vagra","Gujarat",2703,1569,1,4273,"924 ","178936 ",100.00,"178936 ",100.00,92984,85950,2,178936
"Jhagadia","Gujarat",3195,2278,0,5473,"935 ","216973 ",100.00,"216973 ",100.00,112105,104866,2,216973
"Bharuch","Gujarat",2845,1874,1,4720,"932 ","225328 ",100.00,"225328 ",100.00,116608,108716,4,225328
"Ankleshwar","Gujarat",2672,1703,0,4375,"899 ","197710 ",100.00,"197710 ",100.00,104115,93594,1,197710
"Olpad","Gujarat",4760,2719,0,7479,"876 ","296122 ",100.00,"296122 ",100.00,157871,138244,7,296122
"Mangrol","Gujarat",2954,2041,0,4995,"950 ","180153 ",100.00,"180153 ",100.00,92406,87746,1,180153
"Mandvi","Gujarat",3346,2586,1,5933,"1009 ","214781 ",100.00,"214781 ",100.00,106924,107854,3,214781
"Kamrej","Gujarat",5204,2425,0,7629,"808 ","343564 ",100.00,"343564 ",100.00,190002,153562,0,343564
"Surat East","Gujarat",2178,1665,1,3844,"964 ","196226 ",100.00,"196226 ",100.00,99898,96321,7,196226
"Surat North","Gujarat",1674,1091,0,2765,"881 ","154146 ",100.00,"154146 ",100.00,81935,72202,9,154146
"Varachha Road","Gujarat",2855,1416,0,4271,"759 ","191568 ",100.00,"191568 ",100.00,108916,82651,1,191568
"Karanj","Gujarat",1792,734,0,2526,"722 ","148908 ",100.00,"148908 ",100.00,86488,62415,5,148908
"Limbayat","Gujarat",3090,1546,0,4636,"754 ","238581 ",100.00,"238581 ",100.00,136020,102553,8,238581
"Udhna","Gujarat",3108,1602,0,4710,"689 ","229906 ",100.00,"229906 ",100.00,136139,93760,7,229906
"Majura","Gujarat",2428,1432,0,3860,"812 ","227219 ",100.00,"227219 ",100.00,125413,101803,3,227219
"Katargam","Gujarat",3709,1996,0,5705,"772 ","252983 ",100.00,"252983 ",100.00,142804,110179,0,252983
"Surat West","Gujarat",2879,1986,0,4865,"952 ","207733 ",100.00,"207733 ",100.00,106413,101320,0,207733
"Choryasi","Gujarat",4127,2018,0,6145,"702 ","342148 ",100.00,"342148 ",100.00,200995,141150,3,342148
"Bardoli","Gujarat",2461,1635,0,4096,"914 ","208430 ",100.00,"208430 ",100.00,108909,99518,3,208430
"Mahuva","Gujarat",2674,2086,0,4760,"1004 ","205896 ",100.00,"205896 ",100.00,102747,103149,0,205896
"Vyara","Gujarat",2914,2339,0,5253,"1027 ","196705 ",100.00,"196705 ",100.00,97023,99682,0,196705
"Nizar","Gujarat",4237,3428,0,7665,"1017 ","239831 ",99.00,"239829 ",99.00,118924,121003,1,239928
"Dangs","Gujarat",3202,2779,0,5981,"990 ","152169 ",99.00,"152161 ",99.00,76559,75776,0,152335
"Jalalpore","Gujarat",2993,2053,0,5046,"933 ","203945 ",100.00,"203945 ",100.00,105515,98427,3,203945
"Navsari","Gujarat",2521,2034,1,4556,"964 ","216404 ",100.00,"216404 ",100.00,110162,106227,15,216404
"Gandevi","Gujarat",4064,3136,0,7200,"963 ","259704 ",100.00,"259704 ",100.00,132264,127434,6,259704
"Vansda","Gujarat",4159,3420,0,7579,"997 ","261433 ",100.00,"261433 ",100.00,130916,130517,0,261433
"Dharampur","Gujarat",2927,2195,0,5122,"988 ","211330 ",99.00,"210965 ",99.00,107051,105733,0,212784
"Valsad","Gujarat",2682,1815,0,4497,"952 ","227378 ",99.00,"227347 ",99.00,116513,110945,0,227458
"Pardi","Gujarat",1924,1257,0,3181,"886 ","202808 ",100.00,"202808 ",100.00,107531,95281,1,202813
"Kaprada","Gujarat",3175,2120,0,5295,"982 ","215013 ",99.00,"214927 ",99.00,108809,106836,0,215645
"Umbergaon","Gujarat",2816,1630,0,4446,"863 ","221760 ",99.00,"221536 ",99.00,119591,103209,0,222800
"Kalka","Haryana",1804,919,0,2723,"864 ","151296 ",100.00,"151296 ",100.00,81148,70148,0,151296
"Panchkula","Haryana",1915,1169,0,3084,"874 ","186688 ",100.00,"186688 ",100.00,99612,87076,0,186688
"Naraingarh","Haryana",2492,963,0,3455,"862 ","163964 ",100.00,"163964 ",100.00,88051,75913,0,163964
"Ambala Cantt.","Haryana",1739,1235,0,2974,"876 ","166094 ",100.00,"166094 ",100.00,88538,77556,0,166094
"Ambala City","Haryana",2624,1397,0,4021,"888 ","219214 ",100.00,"219214 ",100.00,116139,103075,0,219214
"Mulana (SC)","Haryana",2631,847,0,3478,"837 ","188012 ",100.00,"188012 ",100.00,102374,85638,0,188012
"Sadhaura (SC)","Haryana",3261,951,0,4212,"848 ","190088 ",100.00,"190088 ",100.00,102855,87233,0,190088
"Jagadhri","Haryana",3215,1200,0,4415,"840 ","188136 ",100.00,"188136 ",100.00,102228,85908,0,188136
"Yamunanagar","Haryana",2352,965,0,3317,"838 ","189592 ",100.00,"189592 ",100.00,103168,86424,0,189592
"Radaur","Haryana",2994,1049,0,4043,"850 ","174105 ",100.00,"174105 ",100.00,94122,79983,0,174105
"Ladwa","Haryana",3150,1114,0,4264,"866 ","159206 ",100.00,"159206 ",100.00,85313,73893,0,159206
"Shahbad (SC)","Haryana",2772,813,0,3585,"866 ","142607 ",100.00,"142607 ",100.00,76418,66189,0,142607
"Thanesar","Haryana",2792,1044,0,3836,"858 ","153981 ",100.00,"153981 ",100.00,82854,71127,0,153981
"Pehowa","Haryana",3071,1168,0,4239,"882 ","154567 ",100.00,"154567 ",100.00,82120,72447,0,154567
"Guhla (SC)","Haryana",2633,907,0,3540,"871 ","156874 ",100.00,"156874 ",100.00,83858,73016,0,156874
"Kalayat","Haryana",2585,628,0,3213,"801 ","178997 ",100.00,"178997 ",100.00,99372,79625,0,178997
"Kaithal","Haryana",2675,1062,0,3737,"852 ","173425 ",100.00,"173425 ",100.00,93619,79806,0,173425
"Pundri","Haryana",2782,972,0,3754,"827 ","161592 ",100.00,"161592 ",100.00,88431,73161,0,161592
"Nilokheri (SC)","Haryana",2717,871,0,3588,"850 ","179176 ",100.00,"179176 ",100.00,96867,82309,0,179176
"Indri","Haryana",3185,1054,0,4239,"847 ","168363 ",100.00,"168363 ",100.00,91168,77195,0,168363
"Karnal","Haryana",2270,1335,0,3605,"891 ","195647 ",100.00,"195647 ",100.00,103450,92197,0,195647
"Gharaunda","Haryana",2663,863,0,3526,"831 ","180761 ",100.00,"180761 ",100.00,98732,82029,0,180761
"Assandh","Haryana",3023,931,0,3954,"832 ","193919 ",100.00,"193919 ",100.00,105850,88069,0,193919
"Panipat Rural","Haryana",4032,1420,0,5452,"813 ","191228 ",100.00,"191228 ",100.00,105481,85747,0,191228
"Panipat City","Haryana",2683,1319,0,4002,"850 ","193355 ",100.00,"193355 ",100.00,104492,88863,0,193355
"Israna (SC)","Haryana",3262,1307,0,4569,"845 ","158116 ",100.00,"158116 ",100.00,85685,72431,0,158116
"Samalkha","Haryana",3625,1524,0,5149,"830 ","177176 ",100.00,"177176 ",100.00,96821,80355,0,177176
"Ganaur","Haryana",3362,949,0,4311,"811 ","147339 ",100.00,"147339 ",100.00,81338,66001,0,147339
"Rai","Haryana",1995,646,0,2641,"783 ","144902 ",100.00,"144902 ",100.00,81274,63628,0,144902
"Kharkhauda (SC)","Haryana",1753,557,0,2310,"804 ","135890 ",100.00,"135890 ",100.00,75329,60561,0,135890
"Sonipat","Haryana",2111,1150,0,3261,"887 ","168435 ",100.00,"168435 ",100.00,89267,79168,0,168435
"Gohana","Haryana",2306,785,0,3091,"826 ","148270 ",100.00,"148270 ",100.00,81199,67071,0,148270
"Baroda","Haryana",2274,558,0,2832,"782 ","156577 ",100.00,"156577 ",100.00,87845,68732,0,156577
"Julana","Haryana",2513,878,0,3391,"811 ","158012 ",100.00,"158012 ",100.00,87232,70780,0,158012
"Safidon","Haryana",2615,799,0,3414,"820 ","161531 ",100.00,"161531 ",100.00,88749,72782,0,161531
"Jind","Haryana",2561,1507,0,4068,"863 ","157010 ",100.00,"157010 ",100.00,84256,72754,0,157010
"Uchana kalan","Haryana",2894,871,0,3765,"806 ","186963 ",100.00,"186963 ",100.00,103523,83440,0,186963
"Narwana (SC)","Haryana",2937,910,0,3847,"829 ","185263 ",100.00,"185263 ",100.00,101269,83994,0,185263
"Tohana","Haryana",4073,1825,0,5898,"885 ","200789 ",100.00,"200789 ",100.00,106542,94247,0,200789
"Fatehabad","Haryana",3941,1608,0,5549,"865 ","215948 ",100.00,"215948 ",100.00,115820,100128,0,215948
"Ratia (SC)","Haryana",3524,1511,0,5035,"896 ","192718 ",100.00,"192718 ",100.00,101667,91051,0,192718
"Kalawali (SC)","Haryana",2841,994,0,3835,"873 ","159012 ",100.00,"159012 ",100.00,84913,74099,0,159012
"Dabwali","Haryana",2970,1066,0,4036,"872 ","178593 ",100.00,"178593 ",100.00,95408,83185,0,178593
"Rania","Haryana",3313,1518,0,4831,"884 ","161409 ",100.00,"161409 ",100.00,85683,75726,0,161409
"Sirsa","Haryana",2224,934,0,3158,"882 ","178224 ",100.00,"178224 ",100.00,94686,83538,0,178224
"Ellenabad","Haryana",3293,1617,0,4910,"871 ","164246 ",100.00,"164246 ",100.00,87787,76459,0,164246
"Adampur","Haryana",2506,1032,0,3538,"852 ","149898 ",100.00,"149898 ",100.00,80927,68971,0,149898
"Uklana (SC)","Haryana",2914,970,0,3884,"824 ","175188 ",100.00,"175188 ",100.00,96057,79131,0,175188
"Narnaund","Haryana",2799,829,0,3628,"804 ","180926 ",100.00,"180926 ",100.00,100313,80613,0,180926
"Hansi","Haryana",2356,974,0,3330,"840 ","160974 ",100.00,"160974 ",100.00,87463,73511,0,160974
"Barwala","Haryana",2764,1275,0,4039,"853 ","153127 ",100.00,"153127 ",100.00,82639,70488,0,153127
"Hisar","Haryana",1802,1019,0,2821,"870 ","149090 ",100.00,"149090 ",100.00,79717,69373,0,149090
"Nalwa","Haryana",2197,978,0,3175,"862 ","145983 ",100.00,"145983 ",100.00,78384,67599,0,145983
"Loharu","Haryana",3226,1307,0,4533,"857 ","163440 ",100.00,"163440 ",100.00,88033,75407,0,163440
"Badhra","Haryana",2571,1091,0,3662,"877 ","160187 ",100.00,"160187 ",100.00,85329,74858,0,160187
"Dadri","Haryana",2714,1218,0,3932,"869 ","166221 ",100.00,"166221 ",100.00,88922,77299,0,166221
"Bhiwani","Haryana",2341,1452,0,3793,"864 ","172290 ",100.00,"172290 ",100.00,92426,79864,0,172290
"Tosham","Haryana",2982,1388,0,4370,"853 ","176799 ",100.00,"176799 ",100.00,95418,81381,0,176799
"Bawani Khera (SC)","Haryana",2935,1302,0,4237,"845 ","175075 ",100.00,"175075 ",100.00,94890,80185,0,175075
"Meham","Haryana",1966,639,0,2605,"811 ","159243 ",100.00,"159243 ",100.00,87910,71333,0,159243
"Garhi Sampla-Kiloi","Haryana",2304,757,0,3061,"819 ","179795 ",100.00,"179795 ",100.00,98833,80962,0,179795
"Rohtak","Haryana",1550,925,0,2475,"908 ","165807 ",100.00,"165807 ",100.00,86882,78925,0,165807
"Kalanaur (SC)","Haryana",1932,712,0,2644,"840 ","167998 ",100.00,"167998 ",100.00,91294,76704,0,167998
"Bahadurgarh","Haryana",2639,1000,0,3639,"815 ","172683 ",100.00,"172683 ",100.00,95141,77542,0,172683
"Badli","Haryana",2391,744,0,3135,"846 ","151667 ",100.00,"151667 ",100.00,82152,69515,0,151667
"Jhajjar (SC)","Haryana",2008,694,0,2702,"877 ","149184 ",100.00,"149184 ",100.00,79480,69704,0,149184
"Beri","Haryana",2069,617,0,2686,"833 ","151216 ",100.00,"151216 ",100.00,82476,68740,0,151216
"Ateli","Haryana",1826,462,0,2288,"882 ","162439 ",100.00,"162439 ",100.00,86290,76149,0,162439
"Mahendragarh","Haryana",2017,443,0,2460,"877 ","165142 ",100.00,"165142 ",100.00,87969,77173,0,165142
"Narnaul","Haryana",1514,506,0,2020,"869 ","122154 ",100.00,"122154 ",100.00,65361,56793,0,122154
"Nangal chaudhry","Haryana",1413,298,0,1711,"853 ","129370 ",100.00,"129370 ",100.00,69804,59566,0,129370
"Bawal (SC)","Haryana",2776,1217,0,3993,"895 ","178555 ",100.00,"178555 ",100.00,94219,84336,0,178555
"Kosli","Haryana",3108,1138,0,4246,"903 ","202447 ",100.00,"202447 ",100.00,106387,96060,0,202447
"Rewari","Haryana",2445,1268,0,3713,"880 ","195063 ",100.00,"195063 ",100.00,103762,91301,0,195063
"Pataudi (SC)","Haryana",3789,1203,0,4992,"886 ","187510 ",100.00,"187510 ",100.00,99447,88063,0,187510
"Badshahpur","Haryana",3534,1515,0,5049,"890 ","294145 ",100.00,"294145 ",100.00,155644,138501,0,294145
"Gurgaon","Haryana",2784,1695,0,4479,"913 ","273354 ",100.00,"273354 ",100.00,142886,130468,0,273354
"Sohna","Haryana",3241,1131,0,4372,"861 ","181462 ",100.00,"181462 ",100.00,97497,83965,0,181462
"Nuh","Haryana",4149,1690,0,5839,"844 ","141808 ",100.00,"141808 ",100.00,76912,64896,0,141808
"Ferozepur Jhirka","Haryana",6373,2770,0,9143,"841 ","172693 ",100.00,"172693 ",100.00,93815,78878,0,172693
"Punahana","Haryana",3903,1656,0,5559,"836 ","144063 ",100.00,"144063 ",100.00,78466,65597,0,144063
"Hathin","Haryana",4175,1576,0,5751,"822 ","182183 ",100.00,"182183 ",100.00,100001,82182,0,182183
"Hodal (SC)","Haryana",3433,1267,0,4700,"819 ","157666 ",100.00,"157666 ",100.00,86671,70995,0,157666
"Palwal","Haryana",3212,1043,0,4255,"826 ","190700 ",100.00,"190700 ",100.00,104456,86244,0,190700
"Prithla","Haryana",3415,1137,0,4552,"821 ","160185 ",100.00,"160185 ",100.00,87964,72221,0,160185
"Faridabad NIT","Haryana",2938,1181,0,4119,"750 ","202637 ",100.00,"202637 ",100.00,115778,86859,0,202637
"Badkhal","Haryana",2253,1064,0,3317,"801 ","202828 ",100.00,"202828 ",100.00,112621,90207,0,202828
"Ballabhgarh","Haryana",2703,1112,0,3815,"746 ","184739 ",100.00,"184739 ",100.00,105793,78946,0,184739
"Faridabad","Haryana",2830,1452,0,4282,"815 ","185649 ",100.00,"185649 ",100.00,102286,83363,0,185649
"Tigaon","Haryana",3251,1287,0,4538,"765 ","213534 ",100.00,"213534 ",100.00,120952,92582,0,213534
"Churah","Himachal Pradesh",459,312,0,771,"946 ","62641 ",100.00,"62641 ",100.00,32190,30451,0,62641
"Bharmour","Himachal Pradesh",772,598,0,1370,"925 ","66852 ",100.00,"66852 ",100.00,34723,32129,0,66852
"Chamba","Himachal Pradesh",572,444,0,1016,"969 ","70093 ",100.00,"70095 ",100.00,35601,34494,0,70095
"Dalhousie","Himachal Pradesh",482,350,0,832,"930 ","62378 ",100.00,"62378 ",100.00,32321,30057,0,62378
"Bhattiyat","Himachal Pradesh",563,356,0,919,"953 ","65162 ",100.00,"65162 ",100.00,33359,31803,0,65162
"Nurpur","Himachal Pradesh",544,276,0,820,"931 ","75351 ",100.00,"75351 ",100.00,39013,36338,0,75351
"Indora","Himachal Pradesh",549,293,0,842,"910 ","75510 ",100.00,"75510 ",100.00,39532,35978,0,75510
"Fatehpur","Himachal Pradesh",617,331,0,948,"948 ","72525 ",100.00,"72525 ",100.00,37225,35300,0,72525
"Jawali","Himachal Pradesh",625,327,0,952,"961 ","81273 ",100.00,"81273 ",100.00,41438,39835,0,81273
"Dehra","Himachal Pradesh",475,280,0,755,"1007 ","70346 ",100.00,"70346 ",100.00,35059,35287,0,70346
"Jaswan-Pragpur","Himachal Pradesh",649,360,0,1009,"968 ","68814 ",100.00,"68814 ",100.00,34970,33844,0,68814
"Jawalamukhi","Himachal Pradesh",516,242,0,758,"975 ","66603 ",100.00,"66603 ",100.00,33726,32877,0,66603
"Jaisinghpur","Himachal Pradesh",429,283,0,712,"1068 ","73436 ",100.00,"73436 ",100.00,35516,37920,0,73436
"Sullah","Himachal Pradesh",480,265,0,745,"1027 ","88585 ",100.00,"88585 ",100.00,43708,44877,0,88585
"Nagrota","Himachal Pradesh",437,196,0,633,"969 ","75095 ",100.00,"75095 ",100.00,38140,36955,0,75095
"Kangra","Himachal Pradesh",386,181,0,567,"957 ","69759 ",100.00,"69759 ",100.00,35648,34111,0,69759
"Shahpur","Himachal Pradesh",384,199,0,583,"961 ","72145 ",100.00,"72145 ",100.00,36785,35360,0,72145
"Dharamshala","Himachal Pradesh",228,139,0,367,"941 ","65128 ",100.00,"65128 ",100.00,33562,31566,0,65128
"Palampur","Himachal Pradesh",264,150,0,414,"957 ","64303 ",100.00,"64303 ",100.00,32861,31442,0,64303
"Baijnath","Himachal Pradesh",384,240,0,624,"982 ","75654 ",100.00,"75654 ",100.00,38162,37492,0,75654
"Lahaul & spiti","Himachal Pradesh",247,220,0,467,"1001 ","22446 ",100.00,"22446 ",100.00,11220,11226,0,22446
"Manali","Himachal Pradesh",475,372,0,847,"950 ","62422 ",100.00,"62422 ",100.00,32004,30418,0,62422
"Kullu","Himachal Pradesh",554,450,0,1004,"942 ","75754 ",100.00,"75754 ",100.00,39011,36743,0,75754
"Banjar","Himachal Pradesh",509,525,0,1034,"949 ","62631 ",100.00,"62631 ",100.00,32131,30500,0,62631
"Anni","Himachal Pradesh",570,517,0,1087,"934 ","73793 ",100.00,"73793 ",100.00,38156,35637,0,73793
"Karsog","Himachal Pradesh",661,519,0,1180,"937 ","62768 ",100.00,"62768 ",100.00,32408,30360,0,62768
"Sundernagar","Himachal Pradesh",558,411,0,969,"956 ","69101 ",100.00,"69101 ",100.00,35322,33779,0,69101
"Nachan","Himachal Pradesh",693,488,0,1181,"985 ","71975 ",100.00,"71975 ",100.00,36255,35720,0,71975
"Seraj","Himachal Pradesh",764,653,0,1417,"930 ","69618 ",100.00,"69618 ",100.00,36069,33549,0,69618
"Darang","Himachal Pradesh",591,494,0,1085,"958 ","74137 ",100.00,"74137 ",100.00,37859,36278,0,74137
"Jogindernagar","Himachal Pradesh",603,435,0,1038,"1023 ","85294 ",100.00,"85294 ",100.00,42154,43140,0,85294
"Dharampur","Himachal Pradesh",484,333,0,817,"1052 ","69208 ",100.00,"69208 ",100.00,33723,35485,0,69208
"Mandi","Himachal Pradesh",397,353,0,750,"1024 ","65337 ",100.00,"65337 ",100.00,32282,33055,0,65337
"Balh","Himachal Pradesh",451,321,0,772,"1007 ","66234 ",100.00,"66234 ",100.00,33003,33231,0,66234
"Sarkaghat","Himachal Pradesh",508,374,0,882,"1020 ","76996 ",100.00,"76996 ",100.00,38108,38888,0,76996
"Bhoranj","Himachal Pradesh",409,260,0,669,"1067 ","70863 ",100.00,"70863 ",100.00,34288,36575,0,70863
"Sujanpur","Himachal Pradesh",433,339,0,772,"1073 ","63862 ",100.00,"63862 ",100.00,30802,33060,0,63862
"Hamirpur","Himachal Pradesh",483,301,0,784,"1005 ","65968 ",100.00,"65968 ",100.00,32906,33062,0,65968
"Barsar","Himachal Pradesh",551,381,0,932,"1046 ","74974 ",100.00,"74974 ",100.00,36636,38338,0,74974
"Nadaun","Himachal Pradesh",620,378,0,998,"1015 ","80860 ",100.00,"80860 ",100.00,40136,40724,0,80860
"Chintpurni","Himachal Pradesh",556,373,0,929,"941 ","72452 ",100.00,"72452 ",100.00,37325,35127,0,72452
"Gagret","Himachal Pradesh",564,291,0,855,"966 ","70166 ",100.00,"70166 ",100.00,35686,34480,0,70166
"Haroli","Himachal Pradesh",678,413,0,1091,"924 ","73516 ",100.00,"73516 ",100.00,38217,35298,1,73516
"Una","Himachal Pradesh",629,406,0,1035,"941 ","73592 ",100.00,"73592 ",100.00,37917,35675,0,73592
"Kutlehar","Himachal Pradesh",769,475,0,1244,"974 ","74038 ",100.00,"74038 ",100.00,37509,36529,0,74038
"Jhanduta","Himachal Pradesh",528,352,0,880,"954 ","67079 ",100.00,"67079 ",100.00,34324,32755,0,67079
"Ghumarwin","Himachal Pradesh",490,372,0,862,"1006 ","75589 ",100.00,"75589 ",100.00,37673,37916,0,75589
"Bilaspur","Himachal Pradesh",553,461,0,1014,"970 ","71963 ",100.00,"71963 ",100.00,36533,35430,0,71963
"Sri Naina Deviji","Himachal Pradesh",765,594,0,1359,"915 ","63093 ",100.00,"63093 ",100.00,32953,30140,0,63093
"Arki","Himachal Pradesh",576,336,0,912,"960 ","78503 ",100.00,"78503 ",100.00,40060,38443,0,78503
"Nalagarh","Himachal Pradesh",666,262,0,928,"911 ","75065 ",100.00,"75065 ",100.00,39285,35779,1,75065
"Doon","Himachal Pradesh",486,264,0,750,"902 ","54525 ",100.00,"54525 ",100.00,28662,25863,0,54525
"Solan","Himachal Pradesh",546,439,0,985,"909 ","74526 ",100.00,"74526 ",100.00,39039,35487,0,74526
"Kasauli","Himachal Pradesh",583,390,0,973,"877 ","59447 ",100.00,"59447 ",100.00,31664,27783,0,59447
"Pachhad","Himachal Pradesh",699,643,0,1342,"916 ","64528 ",100.00,"64528 ",100.00,33678,30850,0,64528
"Nahan","Himachal Pradesh",676,434,0,1110,"919 ","69849 ",100.00,"69849 ",100.00,36402,33447,0,69849
"Sri Renukaji","Himachal Pradesh",954,695,0,1649,"911 ","60367 ",100.00,"60367 ",100.00,31592,28775,0,60367
"Paonta Sahib","Himachal Pradesh",665,396,0,1061,"853 ","68409 ",100.00,"68409 ",100.00,36927,31482,0,68409
"Shillai","Himachal Pradesh",809,739,0,1548,"796 ","60836 ",100.00,"60836 ",100.00,33867,26969,0,60836
"Chopal","Himachal Pradesh",563,402,0,965,"897 ","67231 ",100.00,"67231 ",100.00,35437,31794,0,67231
"Theog","Himachal Pradesh",400,330,0,730,"952 ","74247 ",100.00,"74247 ",100.00,38037,36210,0,74247
"Kasumpti","Himachal Pradesh",427,345,0,772,"893 ","61982 ",100.00,"61982 ",100.00,32738,29244,0,61982
"Shimla","Himachal Pradesh",267,254,0,521,"821 ","55582 ",100.00,"55582 ",100.00,30531,25051,0,55582
"Shimla Rural","Himachal Pradesh",534,416,0,950,"928 ","70342 ",100.00,"70342 ",100.00,36478,33864,0,70342
"Jubbal-Kotkhai","Himachal Pradesh",437,405,0,842,"984 ","64417 ",100.00,"64417 ",100.00,32472,31945,0,64417
"Rampur","Himachal Pradesh",453,329,0,782,"918 ","68024 ",100.00,"68024 ",100.00,35471,32553,0,68024
"Rohru","Himachal Pradesh",584,461,0,1045,"912 ","66436 ",100.00,"66436 ",100.00,34741,31695,0,66436
"Kinnaur","Himachal Pradesh",388,289,0,677,"952 ","52487 ",100.00,"52487 ",100.00,26887,25600,0,52487
"Karnah","Jammu & Kashmir",917,711,0,1628,"921 ","26382 ",83.00,"27456 ",87.00,16402,15111,0,31513
"Kupwara","Jammu & Kashmir",2854,2238,0,5092,"901 ","82941 ",81.00,"88171 ",87.00,53262,47991,0,101253
"Lolab","Jammu & Kashmir",2294,1709,0,4003,"865 ","76352 ",81.00,"81085 ",86.00,50098,43318,0,93416
"Handwara","Jammu & Kashmir",1830,1654,0,3484,"912 ","67595 ",79.00,"71099 ",83.00,44501,40604,0,85105
"Langate","Jammu & Kashmir",1459,1200,0,2659,"889 ","55933 ",82.00,"57578 ",85.00,35831,31869,0,67700
"Uri","Jammu & Kashmir",1688,1308,0,2996,"883 ","62919 ",87.00,"66637 ",92.00,38188,33723,0,71911
"Rafiabad","Jammu & Kashmir",1523,1368,0,2891,"912 ","59435 ",76.00,"62034 ",80.00,40475,36922,0,77397
"Sopore","Jammu & Kashmir",1528,1015,0,2543,"907 ","81219 ",82.00,"85177 ",86.00,51610,46805,0,98415
"Gurez","Jammu & Kashmir",339,261,0,600,"885 ","13301 ",77.00,"14630 ",85.00,9058,8013,0,17071
"Bandipora","Jammu & Kashmir",1345,907,0,2252,"891 ","77181 ",81.00,"80525 ",84.00,50319,44846,0,95165
"Sonawari","Jammu & Kashmir",2032,1789,0,3821,"929 ","79833 ",83.00,"82511 ",86.00,49680,46156,0,95836
"Sangrama","Jammu & Kashmir",1131,717,0,1848,"888 ","52739 ",83.00,"55315 ",87.00,33336,29592,0,62928
"Baramulla","Jammu & Kashmir",1119,712,0,1831,"884 ","64926 ",83.00,"68549 ",87.00,41392,36606,0,77998
"Gulmarg","Jammu & Kashmir",1586,1210,0,2796,"906 ","73057 ",79.00,"75215 ",82.00,47938,43410,0,91348
"Pattan","Jammu & Kashmir",1374,1118,0,2492,"909 ","70332 ",81.00,"73196 ",85.00,45000,40900,0,85900
"Kangan","Jammu & Kashmir",1168,697,0,1865,"878 ","57134 ",88.00,"59655 ",92.00,34453,30236,0,64689
"Ganderbal","Jammu & Kashmir",1219,894,0,2113,"914 ","78104 ",90.00,"83125 ",96.00,45090,41197,0,86287
"Hazratbal","Jammu & Kashmir",721,506,0,1227,"890 ","78021 ",83.00,"82706 ",88.00,49421,43999,0,93420
"Zadibal","Jammu & Kashmir",637,514,0,1151,"903 ","64791 ",87.00,"68019 ",92.00,38770,34991,0,73761
"Eidgah","Jammu & Kashmir",493,370,0,863,"901 ","49513 ",87.00,"52591 ",92.00,29907,26943,0,56850
"Khanyar","Jammu & Kashmir",343,313,0,656,"904 ","39815 ",81.00,"41979 ",86.00,25591,23128,0,48719
"Habba kadal","Jammu & Kashmir",185,146,0,331,"949 ","33619 ",65.00,"34881 ",68.00,26165,24836,0,51001
"Amira kadal","Jammu & Kashmir",344,248,0,592,"929 ","64306 ",79.00,"68256 ",83.00,42182,39182,0,81364
"Sonawar","Jammu & Kashmir",444,346,0,790,"901 ","61838 ",84.00,"66468 ",90.00,38592,34784,0,73376
"Batmaloo","Jammu & Kashmir",687,466,0,1153,"904 ","90847 ",80.00,"98083 ",86.00,59590,53896,0,113486
"Chadoora","Jammu & Kashmir",1460,930,0,2390,"913 ","66540 ",81.00,"70245 ",86.00,42528,38822,0,81350
"Budgam","Jammu & Kashmir",2156,1662,0,3818,"904 ","84780 ",85.00,"90840 ",92.00,51811,46862,0,98673
"Beerwah","Jammu & Kashmir",2058,1609,0,3667,"902 ","80810 ",88.00,"86654 ",95.00,47883,43176,0,91059
"Khan Sahib","Jammu & Kashmir",3197,2746,0,5943,"890 ","70805 ",84.00,"76493 ",91.00,44160,39311,0,83471
"Chrar-i-sharief","Jammu & Kashmir",1507,1107,0,2614,"901 ","65110 ",87.00,"68732 ",92.00,39052,35194,0,74246
"Tral","Jammu & Kashmir",1243,820,0,2063,"899 ","73125 ",88.00,"77484 ",93.00,43761,39333,0,83094
"Pampore","Jammu & Kashmir",888,557,0,1445,"923 ","64093 ",84.00,"67888 ",89.00,39602,36535,0,76137
"Pulwama","Jammu & Kashmir",1051,502,0,1553,"879 ","65228 ",85.00,"70346 ",91.00,40778,35860,0,76638
"Rajpora","Jammu & Kashmir",1288,689,0,1977,"868 ","72419 ",83.00,"77876 ",90.00,46166,40054,0,86220
"Wachi","Jammu & Kashmir",1482,855,0,2337,"875 ","63349 ",83.00,"67563 ",88.00,40558,35506,0,76064
"Shopian","Jammu & Kashmir",1234,657,0,1891,"877 ","65370 ",84.00,"69221 ",89.00,41414,36310,0,77724
"Noorabad","Jammu & Kashmir",1503,1096,0,2599,"876 ","69269 ",100.00,"67267 ",97.00,36926,32343,0,69269
"Kulgam","Jammu & Kashmir",1452,1130,0,2582,"897 ","63025 ",69.00,"82528 ",90.00,48004,43061,0,91065
"Hom Shali Bugh","Jammu & Kashmir",1101,705,0,1806,"903 ","69143 ",92.00,"66752 ",89.00,39214,35415,0,74629
"Anantnag","Jammu & Kashmir",763,572,0,1335,"940 ","70118 ",85.00,"74315 ",91.00,42079,39567,0,81646
"Devsar","Jammu & Kashmir",1487,1103,0,2590,"890 ","75165 ",87.00,"76820 ",89.00,45227,40254,0,85481
"Dooru","Jammu & Kashmir",1330,936,0,2266,"884 ","69489 ",98.00,"64797 ",91.00,37434,33095,0,70529
"Kokernag","Jammu & Kashmir",1214,910,0,2124,"869 ","63089 ",76.00,"70609 ",86.00,43927,38169,0,82096
"Shangus","Jammu & Kashmir",1418,1092,0,2510,"903 ","77895 ",98.00,"73581 ",92.00,41707,37672,0,79379
"Bijbehara","Jammu & Kashmir",1056,718,0,1774,"942 ","64495 ",76.00,"76989 ",90.00,43683,41148,0,84831
"Pahalgam","Jammu & Kashmir",1086,811,0,1897,"909 ","71488 ",92.00,"72764 ",94.00,40480,36806,0,77286
"Nubra","Jammu & Kashmir",190,208,0,398,"986 ","11708 ",91.00,"12808 ",100.00,6449,6359,0,12808
"Leh","Jammu & Kashmir",619,527,0,1146,"984 ","59845 ",89.00,"66558 ",100.00,33543,33014,0,66557
"Kargil","Jammu & Kashmir",860,701,0,1561,"952 ","53714 ",89.00,"53363 ",89.00,30642,29179,0,59821
"Zanskar","Jammu & Kashmir",263,220,0,483,"972 ","18287 ",88.00,"19138 ",92.00,10531,10232,0,20763
"Kishtwar","Jammu & Kashmir",689,454,0,1143,"928 ","65718 ",88.00,"69655 ",94.00,38429,35668,0,74097
"Inderwal","Jammu & Kashmir",717,500,0,1217,"885 ","69773 ",88.00,"73488 ",93.00,41661,36883,0,78544
"Doda","Jammu & Kashmir",691,413,0,1104,"880 ","73368 ",93.00,"77255 ",98.00,41647,36638,0,78285
"Bhaderwah","Jammu & Kashmir",821,538,0,1359,"899 ","89956 ",90.00,"94149 ",95.00,52176,46895,0,99071
"Ramban","Jammu & Kashmir",762,383,0,1145,"852 ","72590 ",88.00,"77715 ",94.00,44211,37676,0,81887
"Banihal","Jammu & Kashmir",903,500,0,1403,"845 ","62117 ",83.00,"68238 ",91.00,40532,34261,0,74793
"Gulab Garh","Jammu & Kashmir",691,463,0,1154,"889 ","53608 ",86.00,"56270 ",90.00,32889,29224,0,62113
"Reasi","Jammu & Kashmir",764,491,0,1255,"871 ","92208 ",91.00,"97080 ",95.00,54095,47097,0,101192
"Gool Arnas","Jammu & Kashmir",650,447,0,1097,"873 ","50229 ",86.00,"53104 ",91.00,30959,27019,0,57978
"Udhampur","Jammu & Kashmir",643,287,0,930,"856 ","96164 ",94.00,"101553 ",99.00,54829,46915,0,101744
"Chenani","Jammu & Kashmir",778,292,0,1070,"826 ","78726 ",94.00,"82974 ",99.00,45555,37639,0,83194
"Ram Nagar","Jammu & Kashmir",906,446,0,1352,"834 ","97895 ",94.00,"103243 ",99.00,56498,47119,0,103617
"Bani","Jammu & Kashmir",342,176,0,518,"846 ","35772 ",93.00,"37654 ",98.00,20755,17551,0,38306
"Basohli","Jammu & Kashmir",485,250,0,735,"851 ","64886 ",90.00,"68828 ",96.00,38632,32881,0,71513
"Kathua","Jammu & Kashmir",667,384,0,1051,"847 ","105312 ",92.00,"111351 ",97.00,61571,52172,0,113743
"Billawar","Jammu & Kashmir",545,273,0,818,"833 ","83374 ",92.00,"87757 ",97.00,49188,40982,0,90170
"Hira Nagar","Jammu & Kashmir",858,334,0,1192,"875 ","94559 ",92.00,"98999 ",96.00,54693,47854,0,102547
"Samba","Jammu & Kashmir",942,470,0,1412,"901 ","70568 ",90.00,"72810 ",93.00,41082,37021,0,78103
"Vijay pur","Jammu & Kashmir",980,493,0,1473,"943 ","95327 ",92.00,"100175 ",97.00,52797,49778,0,102575
"Nagrota","Jammu & Kashmir",710,392,0,1102,"835 ","61292 ",91.00,"64761 ",96.00,36641,30603,0,67244
"Gandhi Nagar","Jammu & Kashmir",926,590,0,1516,"926 ","129920 ",81.00,"137420 ",86.00,82590,76457,0,159047
"Jammu East","Jammu & Kashmir",331,216,0,547,"955 ","43134 ",80.00,"44748 ",83.00,27255,26040,0,53295
"Jammu West","Jammu & Kashmir",704,455,0,1159,"951 ","121592 ",81.00,"127527 ",85.00,76274,72504,0,148778
"Bishnah","Jammu & Kashmir",904,493,0,1397,"895 ","79302 ",92.00,"83244 ",96.00,45457,40700,0,86157
"Ranbir singh Pura","Jammu & Kashmir",778,411,0,1189,"878 ","70258 ",92.00,"73160 ",96.00,40243,35339,0,75582
"Suchet Garh","Jammu & Kashmir",561,284,0,845,"940 ","55565 ",92.00,"58394 ",97.00,30918,29056,0,59974
"Marh","Jammu & Kashmir",483,254,0,737,"883 ","62647 ",92.00,"65878 ",97.00,35989,31761,0,67750
"Raipur Domana","Jammu & Kashmir",633,319,0,952,"886 ","82034 ",90.00,"85739 ",94.00,48224,42747,0,90971
"Akhnoor","Jammu & Kashmir",646,306,0,952,"917 ","78328 ",90.00,"82444 ",95.00,45130,41385,0,86515
"Chhamb","Jammu & Kashmir",534,266,0,800,"996 ","63089 ",91.00,"66417 ",95.00,34685,34554,0,69239
"Nowshera","Jammu & Kashmir",781,447,0,1228,"898 ","82523 ",92.00,"86610 ",97.00,46963,42150,0,89113
"Darhal","Jammu & Kashmir",904,603,0,1507,"882 ","74567 ",83.00,"78303 ",88.00,47196,41621,0,88817
"Rajouri","Jammu & Kashmir",1126,710,0,1836,"883 ","93899 ",88.00,"99000 ",93.00,56297,49707,0,106004
"Kala kote","Jammu & Kashmir",832,455,0,1287,"875 ","69967 ",87.00,"73525 ",91.00,42715,37369,0,80084
"Surankote","Jammu & Kashmir",810,356,0,1166,"876 ","75350 ",91.00,"79327 ",95.00,44113,38642,0,82755
"Mendhar","Jammu & Kashmir",845,414,0,1259,"904 ","72071 ",94.00,"75872 ",99.00,40160,36299,0,76459
"Poonch Haveli","Jammu & Kashmir",702,425,0,1127,"891 ","83638 ",87.00,"87856 ",92.00,50305,44812,0,95117
"Rajmahal","Jharkhand",13351,10002,0,23353,"881 ","258193 ",98.00,"258524 ",99.00,138711,122188,0,260899
"Borio","Jharkhand",12325,11223,0,23548,"944 ","221207 ",99.00,"221544 ",99.00,114840,108386,0,223226
"Barhait","Jharkhand",8159,7929,0,16088,"973 ","177263 ",97.00,"176913 ",97.00,92172,89640,0,181812
"Littipara","Jharkhand",15340,16291,0,31631,"1014 ","185630 ",100.00,"185630 ",100.00,92173,93459,0,185632
"Pakur","Jharkhand",19745,16886,0,36631,"970 ","283637 ",99.00,"283685 ",99.00,144077,139703,0,283780
"Maheshpur","Jharkhand",13668,13834,0,27502,"988 ","194928 ",100.00,"194928 ",100.00,98027,96890,1,194918
"Shikaripara","Jharkhand",8071,7640,0,15711,"991 ","184918 ",100.00,"184918 ",100.00,92759,91967,0,184726
"Nala","Jharkhand",7360,7824,0,15184,"906 ","199213 ",99.00,"199061 ",99.00,104729,94893,1,199623
"Jamtara","Jharkhand",8903,6937,0,15840,"899 ","233450 ",99.00,"233402 ",99.00,123542,111067,1,234610
"Dumka","Jharkhand",9585,8346,0,17931,"945 ","216528 ",100.00,"216524 ",100.00,111296,105173,0,216469
"Jama","Jharkhand",8835,7247,0,16082,"976 ","180101 ",100.00,"180101 ",100.00,91104,88924,1,180029
"Jarmundi","Jharkhand",8744,7408,0,16152,"900 ","199412 ",100.00,"199412 ",100.00,104931,94394,0,199325
"Madhupur","Jharkhand",12847,10674,0,23521,"871 ","269910 ",99.00,"269753 ",99.00,144780,126113,0,270893
"Sarath","Jharkhand",9107,8967,1,18075,"900 ","234224 ",99.00,"234106 ",99.00,123577,111214,2,234793
"Deoghar","Jharkhand",14572,14327,0,28899,"866 ","313135 ",99.00,"313185 ",100.00,167868,145291,0,313159
"Poreyahat","Jharkhand",11753,10685,0,22438,"937 ","252346 ",100.00,"252315 ",100.00,129953,121747,0,251700
"Godda","Jharkhand",12790,11475,0,24265,"889 ","257577 ",99.00,"258003 ",99.00,136857,121714,1,258572
"Mahagama","Jharkhand",13325,11554,0,24879,"897 ","264614 ",99.00,"264632 ",99.00,139709,125339,0,265048
"Kodarma","Jharkhand",13734,10700,0,24434,"895 ","290411 ",99.00,"290506 ",99.00,153734,137515,0,291249
"Barkatha","Jharkhand",16893,11371,0,28264,"879 ","283965 ",99.00,"283662 ",99.00,152215,133726,1,285942
"Barhi","Jharkhand",16034,11062,0,27096,"874 ","247689 ",99.00,"247714 ",99.00,133218,116401,1,249620
"Barkagaon","Jharkhand",12675,10608,0,23283,"840 ","303648 ",98.00,"302403 ",98.00,166968,140251,0,307219
"Ramgarh","Jharkhand",13154,15173,0,28327,"893 ","275209 ",99.00,"275632 ",99.00,146071,130492,0,276563
"Mandu","Jharkhand",20539,17083,0,37622,"872 ","337273 ",99.00,"337374 ",99.00,180734,157605,0,338339
"Hazaribagh","Jharkhand",16923,12781,0,29704,"863 ","308218 ",99.00,"308137 ",99.00,165898,143218,1,309117
"Simaria","Jharkhand",19350,13505,0,32855,"875 ","288745 ",99.00,"288536 ",99.00,155013,135613,0,290626
"Chatra","Jharkhand",23370,18724,0,42094,"874 ","326002 ",99.00,"325888 ",99.00,175211,153166,0,328377
"Dhanwar","Jharkhand",9996,6593,0,16589,"876 ","261732 ",99.00,"261227 ",99.00,140464,122988,0,263452
"Bagodar","Jharkhand",10460,7152,0,17612,"897 ","276613 ",99.00,"276364 ",99.00,146104,131055,0,277159
"Jamua","Jharkhand",10001,6703,0,16704,"872 ","256273 ",99.00,"256052 ",99.00,136947,119419,0,256366
"Gandey","Jharkhand",11352,7519,0,18871,"876 ","229153 ",100.00,"229086 ",100.00,121999,106922,0,228921
"Giridih","Jharkhand",10027,7656,0,17683,"861 ","224526 ",99.00,"224276 ",99.00,121550,104690,0,226240
"Dumri","Jharkhand",9566,7145,0,16711,"882 ","237933 ",99.00,"237778 ",99.00,126467,111565,0,238032
"Gomia","Jharkhand",11541,10209,0,21750,"884 ","248908 ",100.00,"248902 ",100.00,132107,116801,1,248909
"Bermo","Jharkhand",13279,12826,1,26106,"854 ","276359 ",100.00,"276359 ",100.00,149086,127271,2,276359
"Bokaro","Jharkhand",20730,18171,0,38901,"821 ","462533 ",100.00,"462532 ",100.00,254037,208509,0,462546
"Chandankyari","Jharkhand",8922,7553,0,16475,"877 ","210669 ",100.00,"210669 ",100.00,112241,98428,0,210669
"Sindri","Jharkhand",12648,11045,0,23693,"868 ","276221 ",99.00,"276047 ",99.00,148346,128719,0,277065
"Nirsa","Jharkhand",13774,11442,0,25216,"868 ","285595 ",100.00,"285602 ",100.00,152166,132052,0,284218
"Dhanbad","Jharkhand",16705,15793,0,32498,"809 ","351784 ",99.00,"351814 ",99.00,194553,157346,2,351901
"Jharia","Jharkhand",11984,7663,0,19647,"736 ","247290 ",99.00,"247517 ",99.00,143258,105443,0,248701
"Tundi","Jharkhand",10899,8856,0,19755,"878 ","244121 ",99.00,"244964 ",99.00,130948,114940,0,245888
"Baghmara","Jharkhand",12808,10103,0,22911,"800 ","246700 ",99.00,"246744 ",99.00,137231,109838,2,247071
"Baharagora","Jharkhand",7823,8683,0,16506,"973 ","210292 ",100.00,"210292 ",100.00,106588,103702,2,210292
"Ghatsila","Jharkhand",8235,9627,0,17862,"991 ","227613 ",100.00,"227613 ",100.00,114315,113281,0,227596
"Potka","Jharkhand",11494,13967,0,25461,"1001 ","262462 ",99.00,"262609 ",100.00,131246,131363,0,262609
"Jugsalai","Jharkhand",13265,15986,0,29251,"950 ","292614 ",99.00,"292687 ",100.00,150076,142610,1,292687
"Jamshedpur  East","Jharkhand",14124,16012,0,30136,"905 ","261219 ",100.00,"261219 ",100.00,137135,124088,0,261223
"Jamshedpur  West","Jharkhand",14937,16153,0,31090,"897 ","295946 ",100.00,"295946 ",100.00,156046,139903,0,295949
"Ichagarh","Jharkhand",9435,8284,0,17719,"919 ","216547 ",100.00,"216546 ",100.00,112854,103691,0,216545
"Saraikella","Jharkhand",13178,12198,1,25377,"928 ","272591 ",100.00,"272599 ",100.00,141425,131173,1,272599
"Chaibasa","Jharkhand",9511,9287,0,18798,"993 ","185251 ",99.00,"185374 ",99.00,93287,92655,0,185942
"Majhganon","Jharkhand",10057,9374,0,19431,"1027 ","168303 ",97.00,"168390 ",97.00,84865,87143,0,172008
"Jaganathpur","Jharkhand",8420,8376,0,16796,"958 ","150240 ",98.00,"150985 ",99.00,77704,74466,1,152171
"Manoharpur","Jharkhand",11797,11617,0,23414,"994 ","181573 ",99.00,"182292 ",99.00,91656,91102,1,182759
"Chakradharpur","Jharkhand",8892,8919,0,17811,"981 ","165731 ",98.00,"167417 ",99.00,84644,83021,0,167665
"Kharasawan","Jharkhand",9349,8930,0,18279,"981 ","183139 ",99.00,"183171 ",100.00,92457,90714,0,183171
"Tamar","Jharkhand",8673,7982,0,16655,"947 ","184070 ",99.00,"184360 ",99.00,94816,89786,0,184602
"Torpa","Jharkhand",8602,8015,0,16617,"957 ","166103 ",99.00,"166102 ",99.00,84934,81250,1,166185
"Khunti","Jharkhand",10107,9560,0,19667,"968 ","185765 ",99.00,"185871 ",100.00,94432,91438,0,185870
"Silli","Jharkhand",6035,5722,0,11757,"947 ","179303 ",98.00,"178592 ",98.00,93519,88520,0,182039
"Khijri","Jharkhand",8951,8396,0,17347,"908 ","273128 ",97.00,"272681 ",96.00,147455,133869,0,281324
"Ranchi","Jharkhand",7567,7041,0,14608,"854 ","269212 ",99.00,"269173 ",99.00,146291,124960,0,271251
"Hatia","Jharkhand",12887,11574,0,24461,"890 ","334272 ",98.00,"332919 ",98.00,179327,159656,0,338983
"Kanke","Jharkhand",11332,9339,0,20671,"890 ","306422 ",98.00,"305752 ",98.00,164607,146435,0,311042
"Mandar","Jharkhand",10289,8366,0,18655,"923 ","270544 ",97.00,"270018 ",97.00,143938,132796,0,276734
"Sisai","Jharkhand",8770,8281,0,17051,"953 ","203800 ",100.00,"203806 ",100.00,104355,99444,0,203799
"Gumla","Jharkhand",8652,8682,0,17334,"950 ","201006 ",100.00,"201006 ",100.00,103055,97951,0,201006
"Bishunpur","Jharkhand",8854,7704,0,16558,"920 ","206920 ",100.00,"206920 ",100.00,107796,99125,0,206921
"Simdega","Jharkhand",6996,7245,0,14241,"969 ","196930 ",99.00,"197003 ",99.00,100266,97149,0,197415
"Kolebira","Jharkhand",6788,6789,0,13577,"967 ","179113 ",99.00,"179029 ",99.00,91173,88176,0,179349
"Lohardaga","Jharkhand",9155,7424,0,16579,"929 ","209318 ",99.00,"209841 ",99.00,108802,101053,0,209855
"Manika","Jharkhand",16448,14688,0,31136,"925 ","208819 ",99.00,"208834 ",99.00,108987,100761,0,209748
"Latehar","Jharkhand",18475,16831,0,35306,"905 ","235634 ",99.00,"236366 ",99.00,124187,112413,0,236600
"Panki","Jharkhand",12749,9254,0,22003,"851 ","235278 ",100.00,"235278 ",100.00,127082,108193,0,235275
"Daltonganj","Jharkhand",13758,10328,0,24086,"857 ","297649 ",99.00,"298617 ",99.00,160939,137921,0,298860
"Bishrampur","Jharkhand",12968,8352,0,21320,"828 ","264915 ",99.00,"264499 ",99.00,145877,120724,0,266601
"Chattarpur","Jharkhand",12448,8392,0,20840,"853 ","231951 ",99.00,"232486 ",99.00,125492,107014,1,232507
"Hussainabad","Jharkhand",12605,8364,0,20969,"804 ","241542 ",100.00,"241542 ",100.00,133859,107683,0,241542
"Garhwa","Jharkhand",12406,8394,0,20800,"871 ","286677 ",98.00,"286502 ",98.00,156047,135892,1,291940
"Bhawanathpur","Jharkhand",11966,7582,0,19548,"861 ","294088 ",99.00,"295301 ",99.00,159215,137041,0,296256
"Nippani","Karnataka",1904,868,0,2772,"949 ","192539 ",99.00,"192290 ",99.00,98998,93903,2,192903
"Chikkodi-Sadalga","Karnataka",1980,1166,1,3147,"939 ","188091 ",99.00,"188075 ",99.00,97033,91089,9,188131
"Athani","Karnataka",2433,1292,0,3725,"913 ","188867 ",99.00,"188757 ",99.00,98968,90397,6,189371
"Kagwad","Karnataka",1721,924,0,2645,"916 ","166071 ",99.00,"166006 ",99.00,86721,79444,12,166177
"Kudachi","Karnataka",1866,988,0,2854,"902 ","151316 ",99.00,"151125 ",99.00,79711,71870,7,151588
"Raybag","Karnataka",1752,828,0,2580,"897 ","165357 ",99.00,"165097 ",99.00,87539,78501,5,166045
"Hukkeri","Karnataka",1786,1232,0,3018,"967 ","176067 ",99.00,"176025 ",99.00,89526,86573,3,176102
"Arabhavi","Karnataka",2166,1201,1,3368,"957 ","199837 ",99.00,"199607 ",99.00,102187,97822,8,200017
"Gokak","Karnataka",2173,1238,0,3411,"979 ","205195 ",99.00,"204735 ",99.00,104053,101890,7,205950
"Yemkanmardi","Karnataka",1439,838,2,2279,"991 ","163370 ",99.00,"163218 ",99.00,82295,81542,9,163846
"Belgaum Uttar","Karnataka",1758,1444,3,3205,"986 ","197667 ",98.00,"196546 ",98.00,100870,99488,29,200387
"Belgaum Dakshin","Karnataka",1795,1176,4,2975,"952 ","203604 ",98.00,"202509 ",98.00,105682,100573,60,206315
"Belgaum Rural","Karnataka",1292,577,2,1871,"959 ","203661 ",98.00,"203304 ",98.00,105189,100850,15,206054
"Khanapur","Karnataka",2150,1012,2,3164,"908 ","185966 ",99.00,"185655 ",99.00,98007,88988,5,187000
"Kittur","Karnataka",1889,1104,0,2993,"948 ","167835 ",99.00,"167803 ",99.00,86158,81695,2,167855
"Bailhongal","Karnataka",2180,1277,2,3459,"957 ","165198 ",99.00,"165153 ",99.00,84451,80798,4,165253
"Saundatti yellamma","Karnataka",2595,1579,0,4174,"961 ","170640 ",99.00,"170591 ",99.00,87180,83738,0,170918
"Ramdurg","Karnataka",2267,1376,0,3643,"922 ","174958 ",99.00,"174760 ",99.00,91352,84233,5,175590
"Mudhol","Karnataka",2449,1691,0,4140,"982 ","167704 ",97.00,"167041 ",96.00,86895,85354,9,172258
"Terdal","Karnataka",2800,1977,2,4779,"967 ","200451 ",99.00,"200241 ",99.00,102528,99093,17,201638
"Jamkhandi","Karnataka",2538,1527,1,4066,"967 ","181529 ",99.00,"181428 ",99.00,92752,89686,12,182450
"Bilgi","Karnataka",2656,1626,3,4285,"980 ","194569 ",99.00,"194301 ",98.00,99178,97200,21,196399
"Badami","Karnataka",2660,1581,0,4241,"974 ","196071 ",98.00,"195291 ",97.00,101342,98726,11,200079
"Bagalkot","Karnataka",2810,1897,2,4709,"976 ","205018 ",98.00,"203803 ",98.00,104903,102415,17,207335
"Hungund","Karnataka",3258,2010,1,5269,"991 ","193217 ",97.00,"192321 ",97.00,99035,98176,7,197218
"Muddebihal","Karnataka",2474,1260,2,3736,"907 ","177468 ",99.00,"177301 ",99.00,93825,85067,31,178923
"Devar Hippargi","Karnataka",2437,1221,2,3660,"889 ","181882 ",99.00,"181559 ",99.00,96931,86218,10,183159
"Basavana Bagevadi","Karnataka",2115,1226,4,3345,"919 ","180201 ",99.00,"180039 ",99.00,93934,86311,13,180258
"Babaleshwar","Karnataka",2589,1327,0,3916,"948 ","182816 ",96.00,"181238 ",95.00,97736,92657,8,190401
"Bijapur City","Karnataka",2538,1739,1,4278,"949 ","206991 ",93.00,"204833 ",92.00,113955,108176,42,222173
"Nagthan","Karnataka",2409,1208,1,3618,"911 ","221324 ",95.00,"218721 ",94.00,120700,109955,24,230679
"Indi","Karnataka",2513,1316,1,3830,"890 ","202074 ",99.00,"201635 ",99.00,107718,95872,16,203606
"Sindgi","Karnataka",2824,1316,2,4142,"881 ","191033 ",99.00,"190483 ",99.00,102028,89846,17,191891
"Afzalpur","Karnataka",2748,1661,0,4409,"921 ","195340 ",99.00,"194638 ",98.00,102678,94612,9,197299
"Jevargi","Karnataka",2654,1907,2,4563,"971 ","201939 ",99.00,"201489 ",99.00,102851,99845,14,202710
"Shorapur","Karnataka",3527,2364,2,5893,"965 ","226745 ",99.00,"225807 ",98.00,116373,112338,24,228735
"Shahapur","Karnataka",2737,1776,2,4515,"981 ","193492 ",99.00,"193119 ",99.00,98331,96470,12,194813
"Yadgir","Karnataka",2811,1775,0,4586,"999 ","198001 ",100.00,"198001 ",100.00,99022,98971,8,198001
"Gurmitkal","Karnataka",2746,1602,0,4348,"999 ","206256 ",98.00,"204446 ",97.00,105175,105057,7,210239
"Chittapur","Karnataka",2598,1467,3,4068,"969 ","197736 ",99.00,"197432 ",99.00,100961,97806,21,198788
"Sedam","Karnataka",2824,1675,0,4499,"997 ","189821 ",99.00,"189320 ",99.00,95434,95134,17,190585
"Chincholi","Karnataka",2754,1343,0,4097,"933 ","175462 ",99.00,"175065 ",99.00,91193,85105,7,176305
"Gulbarga Rural","Karnataka",2732,1519,2,4253,"922 ","217954 ",99.00,"217619 ",99.00,113934,105050,13,218997
"Gulbarga Dakshin","Karnataka",2884,2025,5,4914,"971 ","221504 ",99.00,"220707 ",98.00,113312,110053,61,223426
"Gulbarga Uttar","Karnataka",3340,2304,4,5648,"933 ","220484 ",97.00,"218664 ",97.00,116429,108598,63,225090
"Aland","Karnataka",2710,1570,0,4280,"893 ","198640 ",99.00,"198329 ",99.00,105291,94011,8,199310
"Basavakalyan","Karnataka",2293,1030,0,3323,"891 ","193969 ",97.00,"192943 ",96.00,105396,93900,7,199303
"Humnabad","Karnataka",2669,1391,0,4060,"905 ","205476 ",98.00,"204415 ",97.00,110006,99510,7,209523
"Bidar South","Karnataka",2052,1164,0,3216,"916 ","174829 ",96.00,"173369 ",95.00,94437,86519,7,180963
"Bidar","Karnataka",1805,1172,0,2977,"920 ","177218 ",94.00,"175432 ",93.00,97854,89978,13,187845
"Bhalki","Karnataka",2282,1138,0,3420,"896 ","202930 ",99.00,"202913 ",99.00,107014,95926,3,202943
"Aurad","Karnataka",1782,943,0,2725,"915 ","188521 ",98.00,"187785 ",98.00,99487,91017,9,190513
"Raichur Rural","Karnataka",2496,1450,5,3951,"1020 ","199664 ",99.00,"198323 ",98.00,99796,101750,66,201612
"Raichur","Karnataka",1960,1588,4,3552,"974 ","182655 ",94.00,"180535 ",93.00,97431,94900,74,192405
"Manvi","Karnataka",2605,1543,13,4161,"1008 ","200943 ",98.00,"199472 ",97.00,101862,102674,75,204611
"Devadurga","Karnataka",3419,2459,1,5879,"990 ","189174 ",99.00,"188642 ",99.00,95283,94366,15,189664
"Lingsugur","Karnataka",3492,2269,0,5761,"966 ","204259 ",99.00,"204076 ",99.00,103962,100449,8,204419
"Sindhanur","Karnataka",3567,2271,3,5841,"999 ","202100 ",99.00,"201752 ",99.00,101478,101359,19,202856
"Maski","Karnataka",2633,1468,1,4102,"996 ","168036 ",99.00,"167733 ",99.00,84465,84097,12,168574
"Kushtagi","Karnataka",2928,1843,0,4771,"973 ","195025 ",97.00,"194265 ",97.00,101191,98459,7,199657
"Kanakagiri","Karnataka",2938,1776,1,4715,"1009 ","186187 ",99.00,"186010 ",99.00,92866,93745,11,186622
"Gangawati","Karnataka",2876,2013,0,4889,"997 ","172994 ",98.00,"172227 ",98.00,87674,87438,7,175119
"Yelburga","Karnataka",2919,1810,0,4729,"947 ","184433 ",100.00,"184270 ",100.00,93928,88987,6,182921
"Koppal","Karnataka",3730,2427,1,6158,"979 ","205950 ",97.00,"204660 ",96.00,107110,104809,13,211932
"Shirahatti","Karnataka",2126,1350,0,3476,"938 ","187649 ",100.00,"187627 ",99.00,96839,90805,5,187649
"Gadag","Karnataka",2527,1644,1,4172,"976 ","187201 ",96.00,"187201 ",96.00,98461,96110,13,194584
"Ron","Karnataka",2273,1533,0,3806,"968 ","203970 ",99.00,"203877 ",99.00,103650,100380,10,204040
"Nargund","Karnataka",1983,1310,1489,4782,"961 ","172973 ",99.00,"172968 ",99.00,88193,84780,1493,174466
"Navalgund","Karnataka",1226,737,1,1964,"947 ","183940 ",99.00,"183039 ",98.00,95095,90080,7,185182
"Kundgol","Karnataka",1791,855,0,2646,"918 ","169384 ",99.00,"169004 ",99.00,88622,81362,2,169986
"Dharwad","Karnataka",1834,1250,0,3084,"965 ","187660 ",99.00,"187329 ",99.00,95752,92419,6,188177
"Hubli-dharwad-East","Karnataka",1761,1138,0,2899,"975 ","178415 ",98.00,"177313 ",97.00,91973,89647,0,181620
"Hubli-dharwad-Central","Karnataka",1964,1501,2,3467,"982 ","214151 ",98.00,"212836 ",97.00,109638,107616,21,217275
"Hubli-dharwad- West","Karnataka",1968,1548,0,3516,"989 ","223263 ",97.00,"221835 ",97.00,114871,113662,21,228554
"Kalghatgi","Karnataka",2113,1193,1,3307,"924 ","170528 ",99.00,"170187 ",99.00,89170,82421,7,171598
"Haliyal","Karnataka",1985,1475,1,3461,"951 ","159555 ",100.00,"159554 ",100.00,81797,77756,2,159555
"Karwar","Karnataka",2093,1817,0,3910,"1001 ","208836 ",100.00,"208834 ",100.00,104383,104448,5,208836
"Kumta","Karnataka",1846,1334,0,3180,"963 ","169858 ",100.00,"169850 ",99.00,86529,83332,0,169861
"Bhatkal","Karnataka",2319,1460,1,3780,"939 ","193699 ",100.00,"193700 ",100.00,99883,93818,3,193704
"Sirsi","Karnataka",1978,1487,0,3465,"963 ","176752 ",100.00,"176746 ",100.00,90028,86721,0,176749
"Yellapur","Karnataka",1971,1349,0,3320,"941 ","154491 ",100.00,"154491 ",100.00,79581,74904,6,154491
"Hangal","Karnataka",1793,936,0,2729,"881 ","175643 ",99.00,"175491 ",99.00,93511,82428,4,175943
"Shiggaon","Karnataka",1908,959,873,3740,"881 ","189857 ",99.00,"189704 ",99.00,101119,89048,876,191043
"Haveri","Karnataka",1970,1057,0,3027,"908 ","200489 ",99.00,"200269 ",99.00,105212,95545,8,200765
"Byadgi","Karnataka",2133,1128,0,3261,"913 ","183674 ",99.00,"183545 ",99.00,96092,87710,8,183810
"Hirekerur","Karnataka",1645,847,0,2492,"900 ","164068 ",100.00,"164048 ",99.00,86342,77722,6,164070
"Ranibennur","Karnataka",1982,1402,1,3385,"926 ","202848 ",99.00,"202451 ",99.00,105536,97733,11,203280
"Hadagalli","Karnataka",2653,1657,2,4312,"951 ","165513 ",99.00,"165455 ",99.00,84842,80724,8,165574
"Hagaribommanahalli","Karnataka",3952,2377,3,6332,"965 ","186084 ",98.00,"186084 ",98.00,96572,93234,16,189822
"Vijayanagara","Karnataka",1532,1196,1,2729,"984 ","176625 ",99.00,"176572 ",99.00,89059,87606,35,176700
"Kampli","Karnataka",2423,1401,4,3828,"999 ","185900 ",99.00,"185794 ",99.00,93142,93018,16,186176
"Siruguppa","Karnataka",1796,1078,1,2875,"1025 ","174338 ",99.00,"174134 ",99.00,86565,88747,13,175325
"Bellary","Karnataka",2320,1654,0,3974,"1009 ","180094 ",99.00,"179534 ",99.00,89998,90787,19,180804
"Bellary City","Karnataka",1114,963,0,2077,"1010 ","198841 ",99.00,"198590 ",99.00,99050,100036,9,199095
"Sandur","Karnataka",1288,919,1,2208,"962 ","178991 ",99.00,"177826 ",98.00,91644,88169,32,179845
"Kudligi","Karnataka",2946,1747,1,4694,"955 ","174027 ",99.00,"173574 ",99.00,89027,85061,9,174097
"Molakalmuru","Karnataka",3461,2402,1,5864,"954 ","206123 ",96.00,"205798 ",96.00,109543,104458,13,214014
"Challakere","Karnataka",2773,2087,0,4860,"971 ","193121 ",100.00,"193104 ",99.00,98000,95110,11,193121
"Chitradurga","Karnataka",3231,2556,1,5788,"994 ","230736 ",99.00,"230293 ",99.00,115917,115185,16,231118
"Hiriyur","Karnataka",3444,2890,1,6335,"985 ","220517 ",99.00,"220292 ",99.00,111181,109523,20,220724
"Hosadurga","Karnataka",2427,1908,0,4335,"942 ","178334 ",99.00,"178334 ",99.00,91844,86514,2,178360
"Holalkere","Karnataka",2881,2114,0,4995,"939 ","207911 ",100.00,"207911 ",100.00,107226,100681,4,207911
"Jagalur","Karnataka",2781,1919,2,4702,"954 ","169667 ",99.00,"168416 ",98.00,87343,83366,12,170721
"Harapanahalli","Karnataka",3192,2387,4,5583,"951 ","185144 ",98.00,"184567 ",98.00,95965,91284,18,187267
"Harihar","Karnataka",2579,2045,1,4625,"986 ","196436 ",99.00,"195766 ",99.00,99281,97864,9,197154
"Davanagere North","Karnataka",2548,1942,1,4491,"1002 ","218516 ",99.00,"217620 ",99.00,109602,109872,18,219492
"Davanagere South","Karnataka",2260,1698,0,3958,"992 ","188933 ",99.00,"188634 ",99.00,94942,94170,25,189137
"Mayakonda","Karnataka",1851,1057,0,2908,"944 ","176365 ",100.00,"176346 ",99.00,90710,85654,1,176365
"Channagiri","Karnataka",2314,1720,0,4034,"949 ","177403 ",99.00,"177322 ",99.00,91132,86484,11,177627
"Honnali","Karnataka",2338,1692,1,4031,"959 ","176776 ",99.00,"176701 ",99.00,90354,86612,4,176970
"Shimoga Rural","Karnataka",2035,1332,1,3368,"975 ","191456 ",99.00,"191376 ",99.00,97095,94692,8,191795
"Bhadravati","Karnataka",1778,1276,0,3054,"1021 ","203931 ",99.00,"203674 ",99.00,101183,103274,6,204463
"Shimoga","Karnataka",1704,1358,0,3062,"1000 ","214931 ",97.00,"214425 ",97.00,109826,109798,11,219635
"Tirthahalli","Karnataka",1485,987,0,2472,"998 ","171470 ",100.00,"171464 ",99.00,85823,85651,2,171476
"Shikaripura","Karnataka",2523,1802,2,4327,"964 ","175516 ",99.00,"175498 ",99.00,89368,86143,14,175525
"Sorab","Karnataka",2236,1426,0,3662,"957 ","175607 ",100.00,"175603 ",100.00,89708,85891,8,175607
"Sagar","Karnataka",1936,1354,0,3290,"1001 ","182776 ",100.00,"182776 ",100.00,91342,91429,5,182776
"Byndoor","Karnataka",2131,1523,4,3658,"1112 ","201153 ",100.00,"201143 ",99.00,95239,105910,9,201158
"Kundapura","Karnataka",1609,1183,0,2792,"1103 ","184762 ",100.00,"184762 ",100.00,87850,96906,6,184762
"Udupi","Karnataka",1755,1451,1,3207,"1066 ","185829 ",99.00,"185758 ",99.00,89991,95954,12,185957
"Kapu","Karnataka",1596,1233,0,2829,"1138 ","160881 ",99.00,"160807 ",99.00,75238,85649,3,160890
"Karkal","Karnataka",1752,1383,0,3135,"1126 ","164591 ",100.00,"164587 ",100.00,77413,87180,2,164595
"Sringeri","Karnataka",1211,815,0,2026,"1004 ","150190 ",99.00,"150158 ",99.00,74983,75315,4,150302
"Mudigere","Karnataka",1045,707,0,1752,"1006 ","151660 ",99.00,"151331 ",99.00,75850,76317,5,152172
"Chikmagalur","Karnataka",1233,893,1,2127,"981 ","189722 ",99.00,"188982 ",98.00,96685,94825,11,191521
"Tarikere","Karnataka",985,561,0,1546,"933 ","161995 ",100.00,"161989 ",99.00,83818,78175,6,161999
"Kadur","Karnataka",1066,785,0,1851,"957 ","183131 ",99.00,"182707 ",99.00,93947,89879,6,183832
"Chiknayakanhalli","Karnataka",1901,1340,0,3241,"983 ","199871 ",99.00,"199821 ",99.00,100799,99103,2,199904
"Tiptur","Karnataka",1611,1377,3,2991,"1025 ","173738 ",99.00,"173640 ",99.00,85834,87967,24,173825
"Turuvekere","Karnataka",1940,1382,0,3322,"1003 ","177092 ",99.00,"176791 ",99.00,88493,88785,4,177282
"Kunigal","Karnataka",2040,1354,0,3394,"980 ","173482 ",99.00,"173127 ",99.00,87852,86083,14,173949
"Tumkur City","Karnataka",1787,1511,5,3303,"993 ","214357 ",98.00,"212968 ",98.00,108975,108213,29,217217
"Tumkur Rural","Karnataka",1641,1119,0,2760,"972 ","176813 ",99.00,"175198 ",98.00,90432,87864,9,178305
"Koratagere","Karnataka",2010,1384,2,3396,"966 ","185465 ",99.00,"183679 ",99.00,94329,91154,20,185503
"Gubbi","Karnataka",1587,1028,3,2618,"972 ","169644 ",99.00,"169122 ",99.00,86445,84063,18,170526
"Sira","Karnataka",2211,1677,1,3889,"962 ","203380 ",99.00,"202619 ",99.00,103810,99827,14,203651
"Pavagada","Karnataka",1791,1151,0,2942,"957 ","188956 ",99.00,"188646 ",99.00,96807,92634,3,189444
"Madhugiri","Karnataka",2120,1327,0,3447,"962 ","182143 ",99.00,"181789 ",99.00,92986,89495,4,182485
"Gauribidanur","Karnataka",2151,1479,1,3631,"980 ","190682 ",100.00,"190677 ",100.00,96283,94398,4,190685
"Bagepalli","Karnataka",2128,1374,0,3502,"988 ","178836 ",100.00,"178836 ",100.00,89966,88863,7,178836
"Chikkaballapur","Karnataka",2151,1618,0,3769,"972 ","179692 ",99.00,"179565 ",99.00,91218,88647,17,179882
"Sidlaghatta","Karnataka",2444,1705,0,4149,"975 ","180042 ",99.00,"180004 ",99.00,91173,88884,8,180065
"Chintamani","Karnataka",2155,1562,2,3719,"983 ","189691 ",99.00,"189408 ",99.00,95726,94052,22,189800
"Srinivaspur","Karnataka",2964,2176,0,5140,"976 ","193846 ",99.00,"193566 ",99.00,98298,95903,8,194209
"Mulbagal","Karnataka",2093,1315,0,3408,"961 ","178805 ",99.00,"178716 ",99.00,91240,87673,6,178919
"Kolar gold field","Karnataka",1289,999,0,2288,"983 ","170293 ",99.00,"169860 ",99.00,86434,84990,7,171431
"Bangarapet","Karnataka",2301,1704,3,4008,"974 ","175933 ",100.00,"175846 ",99.00,89114,86803,21,175938
"Kolar","Karnataka",2957,2262,1,5220,"984 ","203626 ",99.00,"202888 ",99.00,103207,101589,30,204826
"Malur","Karnataka",2471,1773,1,4245,"972 ","167406 ",99.00,"167257 ",99.00,84991,82570,7,167568
"Yelahanka","Karnataka",2432,1963,0,4395,"937 ","299271 ",98.00,"297877 ",98.00,156309,146485,29,302823
"K.R.Pura","Karnataka",2317,1937,2,4256,"899 ","349692 ",98.00,"348399 ",98.00,186004,167277,81,353362
"Byatarayanapura","Karnataka",2666,1932,2,4600,"905 ","337714 ",99.00,"335124 ",98.00,178619,161720,36,340375
"Yeshvanthapura","Karnataka",2609,2089,1,4699,"915 ","351087 ",98.00,"349210 ",97.00,186211,170293,31,356535
"Rajarajeshwarinagar","Karnataka",2470,2068,0,4538,"900 ","350131 ",99.00,"349857 ",99.00,184570,166139,4,350713
"Dasarahalli","Karnataka",2721,2112,1,4834,"841 ","349141 ",98.00,"344350 ",97.00,191734,161178,82,352994
"Mahalakshmi Layout","Karnataka",1561,1248,0,2809,"923 ","249184 ",99.00,"248609 ",99.00,129878,119922,22,249822
"Malleshwaram","Karnataka",1172,1095,0,2267,"974 ","180126 ",99.00,"179911 ",99.00,91334,88929,7,180270
"Hebbal","Karnataka",1264,993,1,2258,"931 ","214516 ",99.00,"214176 ",99.00,111152,103532,14,214698
"Pulakeshinagar","Karnataka",1005,864,1,1870,"973 ","180379 ",99.00,"179722 ",99.00,91712,89275,20,181007
"Sarvagnanagar","Karnataka",1612,1350,2,2964,"966 ","279881 ",97.00,"279045 ",97.00,145310,140408,25,285743
"C.V. Raman Nagar","Karnataka",1466,1160,1,2627,"913 ","205181 ",98.00,"204207 ",98.00,108502,99049,66,207617
"Shivajinagar","Karnataka",938,762,0,1700,"963 ","170283 ",99.00,"169879 ",99.00,87008,83826,11,170845
"Shanti Nagar","Karnataka",1383,1045,2,2430,"996 ","183968 ",99.00,"183475 ",98.00,91493,91102,2785,185380
"Gandhi Nagar","Karnataka",1178,813,0,1991,"910 ","196681 ",99.00,"196371 ",99.00,102979,93747,5,196731
"Rajaji Nagar","Karnataka",1035,906,0,1941,"952 ","180081 ",99.00,"179730 ",99.00,92410,87976,9,180395
"Govindraj Nagar","Karnataka",1336,1027,1,2364,"895 ","239484 ",98.00,"238971 ",98.00,128503,115005,29,243537
"Vijay Nagar","Karnataka",1259,1008,0,2267,"901 ","232822 ",97.00,"230246 ",96.00,125573,113081,36,238690
"Chamrajpet","Karnataka",1329,1010,0,2339,"910 ","187295 ",99.00,"186957 ",99.00,98330,89470,11,187811
"Chickpet","Karnataka",1345,983,0,2328,"930 ","190803 ",99.00,"189828 ",98.00,99421,92453,14,191888
"Basavanagudi","Karnataka",1469,1195,0,2664,"934 ","203639 ",99.00,"201554 ",98.00,106131,99122,27,205280
"Padmanaba Nagar","Karnataka",1505,1259,0,2764,"934 ","225503 ",98.00,"224698 ",98.00,118076,110243,8,228327
"B.T.M.Layout","Karnataka",1669,1483,0,3152,"902 ","216047 ",96.00,"215170 ",96.00,117306,105825,23,223154
"Jayanagar","Karnataka",1004,893,1,1898,"963 ","172865 ",98.00,"171768 ",97.00,89443,86124,26,175593
"Mahadevapura","Karnataka",2956,2007,4,4967,"850 ","371941 ",98.00,"369436 ",97.00,205157,174280,108,379545
"Bommanahalli","Karnataka",1797,1527,1,3325,"844 ","319400 ",97.00,"318012 ",97.00,177212,149542,66,326820
"Bangalore South","Karnataka",3292,2544,2,5838,"864 ","453945 ",98.00,"447994 ",96.00,248094,214333,76,462503
"Anekal","Karnataka",3195,2367,3,5565,"877 ","286344 ",98.00,"284665 ",98.00,154256,135258,44,289558
"Hosakote","Karnataka",2493,2072,1,4566,"960 ","188679 ",99.00,"188209 ",99.00,96788,92896,2,189686
"Devanahalli","Karnataka",2526,1940,2,4468,"970 ","187585 ",99.00,"187539 ",99.00,95305,92451,11,187767
"Doddaballapur","Karnataka",2001,1390,0,3391,"956 ","186269 ",99.00,"186164 ",99.00,95283,91124,6,186413
"Nelamangala","Karnataka",1843,1231,2,3076,"971 ","185262 ",99.00,"184998 ",99.00,94516,91735,14,186265
"Magadi","Karnataka",1961,1310,3,3274,"957 ","202788 ",99.00,"202337 ",99.00,104253,99811,19,204083
"Ramanagaram","Karnataka",1498,1075,3,2576,"986 ","179871 ",98.00,"179424 ",97.00,92242,90909,16,183167
"Kanakapura","Karnataka",2531,1731,3,4265,"995 ","208169 ",97.00,"206968 ",97.00,106523,105982,15,212520
"Channapatna","Karnataka",2300,1673,0,3973,"1041 ","200493 ",98.00,"199835 ",98.00,99681,103794,4,203479
"Malavalli","Karnataka",2430,1551,0,3981,"963 ","233857 ",98.00,"233438 ",98.00,120598,116156,12,236766
"Maddur","Karnataka",1582,1129,1,2712,"1009 ","197316 ",99.00,"197131 ",99.00,98876,99793,6,198675
"Melukote","Karnataka",2215,1601,0,3816,"1005 ","192560 ",99.00,"192086 ",99.00,96377,96865,3,193245
"Mandya","Karnataka",1859,1237,1,3097,"1009 ","217765 ",95.00,"214765 ",94.00,112965,113951,12,226928
"Shrirangapattana","Karnataka",2099,1339,0,3438,"1009 ","197832 ",98.00,"192556 ",95.00,100134,100988,3,201125
"Nagamangala","Karnataka",1845,1192,2,3039,"981 ","199711 ",97.00,"199403 ",97.00,102952,100969,9,203930
"Krishnarajpet","Karnataka",1927,1186,1,3114,"957 ","193096 ",99.00,"193012 ",99.00,98710,94417,13,193140
"Shravanabelagola","Karnataka",1718,1334,0,3052,"994 ","192258 ",99.00,"192116 ",99.00,96470,95891,9,192370
"Arsikere","Karnataka",1661,1180,5,2846,"998 ","200219 ",100.00,"200184 ",99.00,100222,99978,19,200219
"Belur","Karnataka",1389,835,0,2224,"961 ","177286 ",100.00,"177264 ",99.00,90413,86868,4,177285
"Hassan","Karnataka",1700,1358,1,3059,"1001 ","187610 ",99.00,"187207 ",99.00,94404,94521,16,188941
"Holenarasipur","Karnataka",1586,1123,0,2709,"978 ","199360 ",99.00,"199273 ",99.00,100812,98628,5,199445
"Arkalgud","Karnataka",1718,952,1,2671,"932 ","200013 ",100.00,"199906 ",99.00,103512,96501,10,200023
"Sakleshpur","Karnataka",1494,1016,0,2510,"996 ","183195 ",99.00,"183156 ",99.00,92174,91760,4,183938
"Belthangady","Karnataka",1633,1031,1,2665,"967 ","195785 ",100.00,"195784 ",100.00,99511,96271,4,195786
"Moodabidri","Karnataka",1664,1163,0,2827,"1082 ","177007 ",100.00,"176989 ",99.00,84998,92000,9,177007
"Mangalore City North","Karnataka",2241,1652,2,3895,"1041 ","210178 ",100.00,"210157 ",99.00,102957,107212,9,210178
"Mangalore City South","Karnataka",2125,2018,2,4145,"1090 ","210870 ",99.00,"210177 ",99.00,101118,110247,10,211375
"Mangalore","Karnataka",2302,1561,3,3866,"1028 ","171534 ",99.00,"171313 ",99.00,84567,86974,16,171557
"Bantval","Karnataka",2250,1537,2,3789,"997 ","199345 ",99.00,"199282 ",99.00,99857,99522,4,199383
"Puttur","Karnataka",2425,1861,1,4287,"971 ","183043 ",100.00,"183043 ",100.00,92884,90153,6,183043
"Sullia","Karnataka",2518,1895,0,4413,"976 ","183069 ",100.00,"183064 ",99.00,92646,90426,5,183077
"Madikeri","Karnataka",2081,1513,1,3595,"1019 ","206573 ",99.00,"206353 ",99.00,102408,104326,13,206747
"Virajpet","Karnataka",2153,1583,0,3736,"998 ","204992 ",99.00,"204768 ",99.00,102625,102396,10,205031
"Periyapatna","Karnataka",1620,987,1,2608,"951 ","166298 ",99.00,"166247 ",99.00,85244,81097,3,166344
"Krishnarajanagara","Karnataka",1706,907,2,2615,"976 ","190314 ",99.00,"190259 ",99.00,96345,94033,7,190385
"Hunsur","Karnataka",2428,1304,0,3732,"964 ","205743 ",99.00,"205228 ",99.00,104829,101107,4,205940
"Heggadadevankote","Karnataka",1866,1080,0,2946,"972 ","195356 ",99.00,"195178 ",99.00,99209,96446,6,195661
"Nanjangud","Karnataka",981,593,0,1574,"959 ","189151 ",99.00,"188899 ",99.00,96704,92740,8,189452
"Chamundeshwari","Karnataka",2380,1453,0,3833,"957 ","247487 ",99.00,"247338 ",99.00,126518,121108,22,247648
"Krishnaraja","Karnataka",1717,1522,0,3239,"1008 ","221665 ",99.00,"221533 ",99.00,110490,111319,18,221827
"Chamaraja","Karnataka",1736,1422,0,3158,"984 ","206602 ",99.00,"206199 ",99.00,104522,102850,26,207398
"Narasimharaja","Karnataka",1995,1534,2,3531,"1004 ","218576 ",99.00,"218203 ",99.00,109449,109856,34,219339
"Varuna","Karnataka",1158,588,0,1746,"946 ","197725 ",99.00,"197633 ",99.00,101789,96276,7,198072
"T.Narasipur","Karnataka",1082,595,0,1677,"972 ","180239 ",99.00,"180184 ",99.00,91455,88931,4,180390
"Hanur","Karnataka",2823,1677,4,4504,"947 ","187795 ",99.00,"187616 ",99.00,96614,91468,10,188092
"Kollegal","Karnataka",2889,1958,0,4847,"981 ","195384 ",99.00,"195237 ",99.00,99228,97315,0,196543
"Chamarajanagar","Karnataka",2737,1953,2,4692,"991 ","187635 ",98.00,"187400 ",98.00,95385,94531,7,189923
"Gundlupet","Karnataka",1704,1107,1,2812,"998 ","193798 ",99.00,"193643 ",99.00,97038,96868,7,193913
"MANJESHWAR","Kerala",2073,1304,0,3377,"994 ","186194 ",100.00,"186236 ",100.00,93413,92823,0,186236
"KASARAGOD","Kerala",1820,1293,0,3113,"991 ","168125 ",100.00,"168182 ",100.00,84470,83712,0,168182
"UDMA","Kerala",2040,1463,0,3503,"1055 ","180198 ",100.00,"180309 ",100.00,87721,92588,0,180309
"KANHANGAD","Kerala",2040,1610,0,3650,"1114 ","185849 ",100.00,"186133 ",100.00,88043,98090,0,186133
"TRIKARIPUR","Kerala",1907,1711,0,3618,"1151 ","175143 ",100.00,"175306 ",100.00,81508,93798,0,175306
"PAYYANNUR","Kerala",1732,1615,0,3347,"1151 ","161572 ",100.00,"161622 ",100.00,75138,86484,0,161622
"KALLIASSERI","Kerala",1900,1620,0,3520,"1276 ","163381 ",100.00,"163506 ",100.00,71836,91670,0,163506
"TALIPARAMBA","Kerala",2209,1931,0,4140,"1185 ","180025 ",100.00,"180218 ",100.00,82462,97756,0,180218
"IRIKKUR","Kerala",2044,1746,0,3790,"1025 ","172722 ",100.00,"172832 ",100.00,85363,87469,0,172832
"AZHIKODE","Kerala",1684,1477,0,3161,"1265 ","153103 ",100.00,"153473 ",100.00,67749,85724,0,153473
"KANNUR","Kerala",1698,1456,0,3154,"1232 ","147352 ",100.00,"147677 ",100.00,66164,81513,0,147677
"DHARMADAM","Kerala",2071,1800,0,3871,"1226 ","167071 ",100.00,"167424 ",100.00,75217,92207,0,167424
"THALASSERY","Kerala",1326,1144,0,2470,"1225 ","154511 ",100.00,"154655 ",100.00,69516,85139,0,154655
"KUTHUPARAMBA","Kerala",1749,1424,0,3173,"1138 ","166144 ",100.00,"166624 ",100.00,77937,88687,0,166624
"MATTANNUR","Kerala",1955,1731,0,3686,"1119 ","167056 ",100.00,"167185 ",100.00,78915,88270,0,167185
"PERAVOOR","Kerala",1841,1460,0,3301,"1037 ","152999 ",100.00,"153057 ",100.00,75145,77912,0,153057
"MANANTHAVADY","Kerala",1744,1403,0,3147,"1027 ","174547 ",100.00,"174607 ",100.00,86145,88462,0,174607
"SULTHANBATHERY","Kerala",1871,1637,0,3508,"1027 ","204478 ",100.00,"204503 ",100.00,100872,103631,0,204503
"KALPETTA","Kerala",1682,1280,0,2962,"1037 ","176407 ",100.00,"176446 ",100.00,86632,89814,0,176446
"VADAKARA","Kerala",1385,1194,0,2579,"1126 ","145108 ",100.00,"145556 ",100.00,68471,77085,0,145556
"KUTTIADI","Kerala",1878,1540,0,3418,"1104 ","165756 ",100.00,"166806 ",100.00,79291,87515,0,166806
"NADAPURAM","Kerala",2194,1671,0,3865,"1027 ","185158 ",100.00,"185736 ",100.00,91640,94096,0,185736
"QUILANDY","Kerala",1656,1347,0,3003,"1164 ","169954 ",100.00,"170209 ",100.00,78658,91551,0,170209
"PERAMBRA","Kerala",1773,1542,0,3315,"1079 ","162904 ",100.00,"163145 ",100.00,78484,84661,0,163145
"BALUSSERI","Kerala",2236,1788,0,4024,"1092 ","189788 ",100.00,"189894 ",100.00,90754,99140,0,189894
"ELATHUR","Kerala",2137,1813,0,3950,"1115 ","168269 ",100.00,"168382 ",100.00,79612,88770,0,168382
"KOZHIKODE NORTH","Kerala",1488,1415,0,2903,"1108 ","152154 ",100.00,"152207 ",100.00,72206,80001,0,152207
"KOZHIKODE SOUTH","Kerala",1259,1118,0,2377,"1077 ","134625 ",100.00,"134677 ",100.00,64857,69820,0,134677
"BEYPORE","Kerala",1865,1492,0,3357,"1065 ","168759 ",100.00,"168807 ",100.00,81746,87061,0,168807
"KUNNAMANGALAM","Kerala",2359,1968,0,4327,"1052 ","185674 ",100.00,"185700 ",100.00,90477,95223,0,185700
"KODUVALLY","Kerala",1979,1248,0,3227,"1013 ","147345 ",100.00,"147444 ",100.00,73233,74211,0,147444
"THIRUVAMBADY","Kerala",1826,1416,0,3242,"1026 ","150927 ",100.00,"150979 ",100.00,74515,76464,0,150979
"KONDOTTY","Kerala",2516,1425,0,3941,"995 ","167572 ",100.00,"167631 ",100.00,84035,83596,0,167631
"ERANAD","Kerala",2126,1269,0,3395,"995 ","147940 ",100.00,"147990 ",100.00,74165,73825,0,147990
"NILAMBUR","Kerala",2621,1779,0,4400,"1063 ","184930 ",100.00,"184956 ",100.00,89653,95303,0,184956
"WANDOOR","Kerala",2774,1537,0,4311,"1064 ","190322 ",100.00,"190334 ",100.00,92213,98121,0,190334
"MANJERI","Kerala",2619,1361,0,3980,"1032 ","172696 ",100.00,"172757 ",100.00,85002,87755,0,172757
"PERINTHALMANNA","Kerala",2394,1515,0,3909,"1080 ","173842 ",100.00,"174038 ",100.00,83673,90365,0,174038
"MANKADA","Kerala",2434,1387,0,3821,"1050 ","172784 ",100.00,"172948 ",100.00,84347,88601,0,172948
"MALAPPURAM","Kerala",3104,1707,0,4811,"986 ","175982 ",100.00,"176030 ",100.00,88645,87385,0,176030
"VENGARA","Kerala",2176,1069,0,3245,"930 ","150837 ",100.00,"150952 ",100.00,78195,72757,0,150952
"VALLIKKUNNU","Kerala",2416,1550,0,3966,"973 ","163456 ",100.00,"163549 ",100.00,82888,80661,0,163549
"TIRURANGADI","Kerala",2483,1383,0,3866,"977 ","160576 ",100.00,"160713 ",100.00,81280,79433,0,160713
"TANUR","Kerala",2100,1119,0,3219,"1041 ","147379 ",100.00,"147736 ",100.00,72394,75342,0,147736
"TIRUR","Kerala",2346,1178,0,3524,"1118 ","175004 ",100.00,"175664 ",100.00,82940,92724,0,175664
"KOTTAKKAL","Kerala",2352,1070,0,3422,"1031 ","175204 ",100.00,"175355 ",100.00,86322,89033,0,175355
"THAVANUR","Kerala",1978,1314,0,3292,"1083 ","164461 ",100.00,"164506 ",100.00,78964,85542,0,164506
"PONNANI","Kerala",1487,984,0,2471,"1105 ","165446 ",100.00,"165546 ",100.00,78645,86901,0,165546
"THRITHALA","Kerala",2262,1557,0,3819,"1086 ","162174 ",100.00,"162282 ",100.00,77782,84500,0,162282
"PATTAMBI","Kerala",1987,1079,0,3066,"1045 ","160113 ",100.00,"160155 ",100.00,78333,81822,0,160155
"SHORNUR","Kerala",1839,1249,0,3088,"1107 ","168557 ",100.00,"168595 ",100.00,80010,88585,0,168595
"OTTAPALAM","Kerala",2062,1426,0,3488,"1096 ","180823 ",100.00,"180850 ",100.00,86283,94567,0,180850
"KONGAD","Kerala",1749,1268,0,3017,"1039 ","157904 ",100.00,"157909 ",100.00,77433,80476,0,157909
"MANNARKAD","Kerala",1752,1134,0,2886,"1063 ","173744 ",100.00,"173787 ",100.00,84222,89565,0,173787
"MALAMPUZHA","Kerala",1857,1630,0,3487,"1042 ","185048 ",100.00,"185052 ",100.00,90645,94407,0,185052
"PALAKKAD","Kerala",1385,1313,0,2698,"1044 ","156545 ",100.00,"156556 ",100.00,76576,79980,0,156556
"TARUR","Kerala",1642,1428,0,3070,"1039 ","152534 ",100.00,"152562 ",100.00,74805,77757,0,152562
"CHITTUR","Kerala",1586,1460,0,3046,"1032 ","172895 ",100.00,"172903 ",100.00,85098,87805,0,172903
"NENMARA","Kerala",1937,1693,0,3630,"1015 ","177803 ",100.00,"177812 ",100.00,88260,89552,0,177812
"ALATHUR","Kerala",1682,1419,0,3101,"1019 ","154991 ",100.00,"155016 ",100.00,76777,78239,0,155016
"CHELAKKARA","Kerala",1763,1363,0,3126,"1091 ","177993 ",100.00,"178011 ",100.00,85143,92868,0,178011
"KUNNAMKULAM","Kerala",1636,1365,0,3001,"1100 ","176205 ",100.00,"176229 ",100.00,83931,92298,0,176229
"GURUVAYOOR","Kerala",1444,1125,0,2569,"1121 ","182283 ",100.00,"182384 ",100.00,85990,96394,0,182384
"MANALUR","Kerala",1693,1619,0,3312,"1124 ","193006 ",100.00,"193049 ",100.00,90906,102143,0,193049
"WADAKKANCHERY","Kerala",1886,1690,0,3576,"1098 ","180648 ",100.00,"180666 ",100.00,86112,94554,0,180666
"OLLUR","Kerala",1437,1521,0,2958,"1059 ","177987 ",100.00,"177995 ",100.00,86466,91529,0,177995
"THRISSUR","Kerala",1100,1231,0,2331,"1106 ","161163 ",100.00,"161191 ",100.00,76530,84661,0,161191
"NATTIKA","Kerala",1448,1424,0,2872,"1149 ","181446 ",100.00,"181494 ",100.00,84458,97036,0,181494
"KAIPAMANGALAM","Kerala",1079,1111,0,2190,"1144 ","153798 ",100.00,"153934 ",100.00,71813,82121,0,153934
"IRINJALAKKUDA","Kerala",1259,1299,0,2558,"1123 ","175688 ",100.00,"175733 ",100.00,82784,92949,0,175733
"PUTHUKKAD","Kerala",1738,1487,0,3225,"1064 ","178768 ",100.00,"178789 ",100.00,86624,92165,0,178789
"CHALAKKUDY","Kerala",1254,1472,0,2726,"1067 ","174958 ",100.00,"174971 ",100.00,84663,90308,0,174971
"KODUNGALLUR","Kerala",1239,1426,0,2665,"1083 ","171350 ",100.00,"171435 ",100.00,82318,89117,0,171435
"PERUMBAVOOR","Kerala",1358,1098,0,2456,"978 ","156158 ",100.00,"156178 ",100.00,78969,77209,0,156178
"ANGAMALY","Kerala",1244,951,0,2195,"984 ","151121 ",100.00,"151154 ",100.00,76184,74970,0,151154
"ALUVA","Kerala",1266,1126,0,2392,"1011 ","158054 ",100.00,"158101 ",100.00,78615,79486,0,158101
"KALAMASSERY","Kerala",1384,1221,0,2605,"1039 ","168457 ",100.00,"168474 ",100.00,82632,85842,0,168474
"PARAVUR","Kerala",1297,1280,0,2577,"1054 ","173014 ",100.00,"173033 ",100.00,84244,88789,0,173033
"VYPEN","Kerala",986,1055,0,2041,"1047 ","153499 ",100.00,"153511 ",100.00,74982,78529,0,153511
"KOCHI","Kerala",1061,1122,0,2183,"1046 ","157949 ",100.00,"157957 ",100.00,77199,80758,0,157957
"THRIPUNITHURA","Kerala",1197,1266,0,2463,"1043 ","175304 ",100.00,"175312 ",100.00,85810,89502,0,175312
"ERANAKULAM","Kerala",882,918,0,1800,"1031 ","139595 ",100.00,"139630 ",100.00,68754,70876,0,139630
"THRIKKAKARA","Kerala",1149,1150,0,2299,"1049 ","162085 ",100.00,"162123 ",100.00,79133,82990,0,162123
"KUNNATHUNAD","Kerala",1303,1244,0,2547,"989 ","155340 ",100.00,"155360 ",100.00,78107,77253,0,155360
"PIRAVOM","Kerala",1479,1393,0,2872,"1038 ","183817 ",100.00,"183839 ",100.00,90187,93652,0,183839
"MUVATTUPUZHA","Kerala",1289,1069,0,2358,"983 ","157478 ",100.00,"157509 ",100.00,79410,78099,0,157509
"KOTHAMANGALAM","Kerala",1081,888,0,1969,"972 ","144969 ",100.00,"144995 ",100.00,73529,71466,0,144995
"DEVIKULAM","Kerala",1201,968,0,2169,"994 ","153661 ",100.00,"153661 ",100.00,77046,76615,0,153661
"UDUMBANCHOLA","Kerala",1105,823,0,1928,"1009 ","157160 ",100.00,"157162 ",100.00,78234,78928,0,157162
"THODUPUZHA","Kerala",1390,1238,0,2628,"1010 ","183282 ",100.00,"183325 ",100.00,91213,92112,0,183325
"IDUKKI","Kerala",1220,1026,0,2246,"999 ","172849 ",100.00,"172852 ",100.00,86472,86380,0,172852
"PEERUMADE","Kerala",1255,1000,0,2255,"1027 ","168154 ",100.00,"168160 ",100.00,82965,85195,0,168160
"PALA","Kerala",1693,1403,0,3096,"1025 ","170814 ",100.00,"170834 ",100.00,84349,86485,0,170834
"KADUTHURUTHY","Kerala",1541,1154,0,2695,"1014 ","173500 ",100.00,"173538 ",100.00,86155,87383,0,173538
"VAIKOM","Kerala",1333,1257,0,2590,"1015 ","153087 ",100.00,"153106 ",100.00,75994,77112,0,153106
"ETTUMANOOR","Kerala",1360,1199,0,2559,"1010 ","151331 ",100.00,"151352 ",100.00,75291,76061,0,151352
"KOTTAYAM","Kerala",1367,1298,0,2665,"1043 ","149060 ",100.00,"149101 ",100.00,72974,76127,0,149101
"PUTHUPPALLY","Kerala",1493,1270,0,2763,"1023 ","158809 ",100.00,"158833 ",100.00,78495,80338,0,158833
"CHANGANASSERY","Kerala",1327,1211,0,2538,"1076 ","153989 ",100.00,"154024 ",100.00,74205,79819,0,154024
"KANJIRAPPALLY","Kerala",1447,1186,0,2633,"1032 ","164699 ",100.00,"164731 ",100.00,81058,83673,0,164731
"POONJAR","Kerala",1600,1237,0,2837,"994 ","170217 ",100.00,"170233 ",100.00,85374,84859,0,170233
"AROOR","Kerala",1254,1270,0,2524,"1019 ","175651 ",100.00,"175657 ",100.00,87001,88656,0,175657
"CHERTHALA","Kerala",1462,1326,0,2788,"1042 ","191749 ",100.00,"191752 ",100.00,93898,97854,0,191752
"ALAPPUZHA","Kerala",1287,1362,0,2649,"1065 ","175468 ",100.00,"175474 ",100.00,84994,90488,0,175482
"AMBALAPUZHA","Kerala",1222,1128,0,2350,"1084 ","150358 ",100.00,"150371 ",100.00,72171,78200,0,150371
"KUTTANAD","Kerala",1385,1083,0,2468,"1070 ","151028 ",100.00,"151047 ",100.00,72985,78062,0,151047
"HARIPAD","Kerala",1227,1119,0,2346,"1169 ","170462 ",100.00,"170504 ",100.00,78617,91887,0,170504
"KAYAMKULAM","Kerala",1440,1285,0,2725,"1175 ","181394 ",100.00,"181427 ",100.00,83414,98013,0,181427
"MAVELIKARA","Kerala",1321,1202,0,2523,"1192 ","179175 ",100.00,"179213 ",100.00,81769,97444,0,179213
"CHENGANNUR","Kerala",1291,1213,0,2504,"1185 ","179160 ",100.00,"179273 ",100.00,82036,97237,0,179273
"THIRUVALLA","Kerala",1399,1098,0,2497,"1135 ","195453 ",100.00,"195594 ",100.00,91625,103969,0,195594
"RANNI","Kerala",1401,1156,0,2557,"1090 ","177942 ",100.00,"178016 ",100.00,85165,92851,0,178016
"ARANMULA","Kerala",1484,1337,0,2821,"1160 ","209445 ",100.00,"209582 ",100.00,97028,112554,0,209582
"KONNI","Kerala",1535,1349,0,2884,"1143 ","183200 ",100.00,"183286 ",100.00,85519,97767,0,183286
"ADOOR","Kerala",1432,1365,0,2797,"1158 ","196775 ",100.00,"196825 ",100.00,91227,105598,0,196825
"KARUNAGAPPALLY","Kerala",1286,1279,0,2565,"1073 ","186011 ",100.00,"186037 ",100.00,89725,96312,0,186037
"CHAVARA","Kerala",1148,1104,0,2252,"1073 ","160803 ",100.00,"160850 ",100.00,77603,83247,0,160850
"KUNNATHUR","Kerala",1469,1433,0,2902,"1094 ","197042 ",100.00,"197053 ",100.00,94124,102929,0,197053
"KOTTARAKKARA","Kerala",1375,1273,0,2648,"1128 ","185070 ",100.00,"185096 ",100.00,86974,98122,0,185096
"PATHANAPURAM","Kerala",1348,1250,0,2598,"1132 ","176329 ",100.00,"176343 ",100.00,82694,93649,0,176343
"PUNALUR","Kerala",1513,1304,0,2817,"1120 ","192097 ",100.00,"192122 ",100.00,90619,101503,0,192122
"CHADAYAMANGALAM","Kerala",1534,1358,0,2892,"1161 ","181118 ",100.00,"181127 ",100.00,83828,97299,0,181127
"KUNDARA","Kerala",1411,1402,0,2813,"1119 ","182289 ",100.00,"182316 ",100.00,86036,96280,0,182316
"KOLLAM","Kerala",1161,1146,0,2307,"1100 ","159746 ",100.00,"159772 ",100.00,76093,83679,0,159772
"ERAVIPURAM","Kerala",974,1003,0,1977,"1109 ","154779 ",100.00,"154802 ",100.00,73384,81418,0,154802
"CHATHANNUR","Kerala",1253,1134,0,2387,"1216 ","164748 ",100.00,"164774 ",100.00,74341,90433,0,164774
"VARKALA","Kerala",1517,1425,0,2942,"1276 ","159048 ",100.00,"159104 ",100.00,69895,89209,0,159104
"ATTINGAL","Kerala",1704,1716,0,3420,"1283 ","179846 ",100.00,"179914 ",100.00,78796,101118,0,179914
"CHIRAYINKEEZHU","Kerala",1599,1528,0,3127,"1281 ","176863 ",100.00,"176941 ",100.00,77579,99362,0,176941
"NEDUMANGAD","Kerala",1569,1452,0,3021,"1121 ","183357 ",100.00,"183374 ",100.00,86476,96898,0,183374
"VAMANAPURAM","Kerala",1563,1506,0,3069,"1152 ","181782 ",100.00,"181797 ",100.00,84494,97303,0,181797
"KAZHAKKOOTTAM","Kerala",1241,1195,0,2436,"1107 ","163793 ",100.00,"163807 ",100.00,77726,86081,0,163807
"VATTIYOORKAVU","Kerala",1217,1263,0,2480,"1088 ","177635 ",100.00,"177670 ",100.00,85088,92582,0,177670
"THIRUVANANTHAPURAM","Kerala",1309,1165,0,2474,"1069 ","177295 ",100.00,"177323 ",100.00,85705,91618,0,177323
"NEMOM","Kerala",1318,1218,0,2536,"1071 ","173646 ",100.00,"173656 ",100.00,83846,89810,0,173656
"ARUVIKKARA","Kerala",1374,1239,0,2613,"1124 ","171486 ",100.00,"171493 ",100.00,80722,90771,0,171493
"PARASSALA","Kerala",1846,1761,0,3607,"1093 ","194919 ",100.00,"194919 ",100.00,93109,101810,0,194919
"KATTAKKADA","Kerala",1582,1353,0,2935,"1103 ","170733 ",100.00,"170735 ",100.00,81196,89539,0,170735
"KOVALAM","Kerala",1977,1646,0,3623,"1055 ","189174 ",100.00,"189178 ",100.00,92056,97122,0,189178
"NEYYATTINKARA","Kerala",1590,1511,0,3101,"1072 ","166348 ",100.00,"166348 ",100.00,80276,86072,0,166348
"Lakshadweep","Lakshadweep",1044,1006,0,2050,"981 ","47972 ",100.00,"47972 ",100.00,24216,23756,0,47972
"SHEOPUR","Madhya Pradesh",2696,1964,0,4660,"863 ","212330 ",100.00,"212330 ",100.00,113957,98372,1,212330
"VIJAYPUR","Madhya Pradesh",4034,2753,0,6787,"823 ","208074 ",100.00,"208074 ",100.00,114169,93905,0,208074
"SABALAGADH","Madhya Pradesh",3404,2142,0,5546,"835 ","189160 ",100.00,"189160 ",100.00,103075,86081,4,189160
"JAURA","Madhya Pradesh",3893,2375,0,6268,"810 ","218627 ",100.00,"218627 ",100.00,120804,97816,7,218627
"SUMAOLI","Madhya Pradesh",3539,2035,0,5574,"792 ","218873 ",100.00,"218873 ",100.00,122121,96747,5,218873
"MORENA","Madhya Pradesh",3320,1515,0,4835,"794 ","237017 ",100.00,"237017 ",100.00,132138,104874,5,237017
"DIMANI","Madhya Pradesh",3111,1443,1,4555,"784 ","194128 ",100.00,"194128 ",100.00,108833,85292,3,194128
"AMBAH","Madhya Pradesh",3155,2080,0,5235,"815 ","201094 ",100.00,"201094 ",100.00,110798,90290,6,201094
"ATER","Madhya Pradesh",2837,1100,0,3937,"759 ","197325 ",100.00,"197325 ",100.00,112149,85174,2,197325
"BHIND","Madhya Pradesh",2949,1171,0,4120,"779 ","224948 ",100.00,"224948 ",100.00,126463,98485,0,224948
"LAHAR","Madhya Pradesh",2968,1445,0,4413,"778 ","222927 ",100.00,"222927 ",100.00,125408,97518,1,222927
"MEHGAON","Madhya Pradesh",3031,1092,0,4123,"751 ","231504 ",100.00,"231504 ",100.00,132202,99300,2,231504
"GOHAD","Madhya Pradesh",2848,1147,0,3995,"764 ","195176 ",100.00,"195176 ",100.00,110620,84555,1,195176
"GWALIOR RURAL","Madhya Pradesh",3345,1474,1,4820,"761 ","207582 ",100.00,"207582 ",100.00,117878,89693,11,207582
"GWALIOR","Madhya Pradesh",3681,1905,0,5586,"836 ","264714 ",100.00,"264714 ",100.00,144136,120548,30,264714
"GWALIOR EAST","Madhya Pradesh",4401,2200,1,6602,"839 ","274739 ",100.00,"274739 ",100.00,149425,125307,7,274739
"GWALIOR SOUTH","Madhya Pradesh",2825,1541,1,4367,"879 ","238145 ",100.00,"238145 ",100.00,126731,111389,26,238146
"BHITRWAR","Madhya Pradesh",3609,1540,0,5149,"811 ","206738 ",100.00,"206738 ",100.00,114120,92600,18,206738
"DABARA","Madhya Pradesh",3233,2096,1,5330,"853 ","201972 ",100.00,"201972 ",100.00,108987,92966,19,201972
"SEWDA","Madhya Pradesh",2367,1935,0,4302,"851 ","164698 ",100.00,"164698 ",100.00,88989,75707,2,164698
"BHANDER","Madhya Pradesh",2185,1234,0,3419,"853 ","163015 ",100.00,"163015 ",100.00,87974,75033,8,163015
"DATIA","Madhya Pradesh",2381,1278,1,3660,"851 ","176846 ",100.00,"176846 ",100.00,95547,81289,10,176846
"KARERA","Madhya Pradesh",6404,5218,0,11622,"841 ","231492 ",100.00,"231492 ",100.00,125763,105726,3,231492
"POHARI","Madhya Pradesh",5927,4322,1,10250,"840 ","210844 ",100.00,"210844 ",100.00,114591,96249,4,210844
"SHIVPURI","Madhya Pradesh",4660,3649,0,8309,"875 ","227139 ",100.00,"227139 ",100.00,121122,106010,7,227139
"PICHHORE","Madhya Pradesh",5807,5174,0,10981,"878 ","225577 ",100.00,"225577 ",100.00,120102,105472,3,225577
"KOLARAS","Madhya Pradesh",6311,5004,0,11315,"851 ","225907 ",100.00,"225907 ",100.00,122064,103841,2,225907
"BAMORI","Madhya Pradesh",4495,3149,0,7644,"887 ","183865 ",100.00,"183865 ",100.00,97444,86421,0,183865
"GUNA","Madhya Pradesh",3511,2370,0,5881,"882 ","195900 ",100.00,"195900 ",100.00,104084,91816,0,195900
"CHACHODA","Madhya Pradesh",4225,3651,1,7877,"875 ","197146 ",100.00,"197146 ",100.00,105160,91986,1,197147
"RAGHOGARH","Madhya Pradesh",4502,3400,0,7902,"874 ","195793 ",100.00,"195793 ",100.00,104477,91315,1,195793
"ASHOK NAGAR","Madhya Pradesh",2317,1776,0,4093,"875 ","180523 ",100.00,"180523 ",100.00,96296,84224,3,180523
"CHANDERI","Madhya Pradesh",2324,1634,0,3958,"871 ","168880 ",100.00,"168880 ",100.00,90265,78613,2,168880
"MUNGAOLI","Madhya Pradesh",2694,2007,0,4701,"854 ","181844 ",100.00,"181844 ",100.00,98107,83735,2,181844
"BINA","Madhya Pradesh",3446,2823,0,6269,"893 ","168737 ",100.00,"168737 ",100.00,89128,79594,15,168737
"KHURAI","Madhya Pradesh",4157,3271,0,7428,"879 ","180755 ",100.00,"180755 ",100.00,96181,84568,6,180755
"SURKHI","Madhya Pradesh",3180,1873,0,5053,"828 ","187500 ",100.00,"187500 ",100.00,102578,84921,1,187500
"DEORI","Madhya Pradesh",2574,1950,0,4524,"878 ","190145 ",100.00,"190145 ",100.00,101238,88906,1,190145
"REHLI","Madhya Pradesh",2906,2093,0,4999,"871 ","213691 ",100.00,"213691 ",100.00,114215,99457,19,213691
"NARYAWALI","Madhya Pradesh",2280,1498,0,3778,"839 ","209024 ",100.00,"209024 ",100.00,113624,95381,19,209024
"SAGAR","Madhya Pradesh",2299,1902,0,4201,"915 ","198775 ",100.00,"198775 ",100.00,103812,94949,14,198775
"BANDA","Madhya Pradesh",2423,1460,0,3883,"853 ","214200 ",100.00,"214200 ",100.00,115594,98605,1,214200
"TIKAMGARH","Madhya Pradesh",2270,1693,1,3964,"883 ","189152 ",100.00,"189152 ",100.00,100464,88683,6,189153
"JATARA","Madhya Pradesh",2363,1707,0,4070,"869 ","183051 ",100.00,"183051 ",100.00,97944,85103,4,183051
"PRITHVIPUR","Madhya Pradesh",1999,1445,1,3445,"864 ","175659 ",100.00,"175659 ",100.00,94243,81411,6,175660
"NIWARI","Madhya Pradesh",1823,1321,0,3144,"881 ","172972 ",100.00,"172972 ",100.00,91934,81035,3,172972
"KHARGAPUR","Madhya Pradesh",3570,2827,0,6397,"863 ","207697 ",100.00,"207697 ",100.00,111496,96198,3,207697
"MAHARAJPUR","Madhya Pradesh",2930,1812,0,4742,"853 ","196033 ",100.00,"196033 ",100.00,105817,90215,1,196033
"CHANDLA","Madhya Pradesh",4078,2283,0,6361,"799 ","195927 ",100.00,"195927 ",100.00,108924,87003,0,195927
"RAJNAGAR","Madhya Pradesh",3208,1833,0,5041,"829 ","203003 ",100.00,"203003 ",100.00,110977,92026,0,203003
"CHHATARPUR","Madhya Pradesh",2762,1859,1,4622,"858 ","192514 ",100.00,"192514 ",100.00,103617,88896,2,192515
"BIJAWAR","Madhya Pradesh",3965,2307,0,6272,"825 ","188903 ",100.00,"188903 ",100.00,103494,85409,0,188903
"MALHARA","Madhya Pradesh",3256,2261,0,5517,"832 ","192663 ",100.00,"192663 ",100.00,105153,87503,7,192663
"PATHARIYA","Madhya Pradesh",3213,1702,0,4915,"866 ","201334 ",100.00,"201334 ",100.00,107915,93417,2,201334
"DAMOH","Madhya Pradesh",3205,2056,0,5261,"897 ","218453 ",100.00,"218453 ",100.00,115170,103277,6,218453
"JABERA","Madhya Pradesh",3166,2203,0,5369,"900 ","201600 ",100.00,"201600 ",100.00,106098,95502,0,201600
"HATTA","Madhya Pradesh",2890,1706,0,4596,"870 ","204945 ",100.00,"204945 ",100.00,109604,95341,0,204945
"PAWAI","Madhya Pradesh",4317,3223,0,7540,"890 ","243920 ",100.00,"243920 ",100.00,129090,114830,0,243920
"GUNNOUR","Madhya Pradesh",3738,2617,0,6355,"880 ","197382 ",100.00,"197382 ",100.00,104986,92396,0,197382
"PANNA","Madhya Pradesh",3993,3255,0,7248,"862 ","217245 ",100.00,"217245 ",100.00,116661,100583,1,217245
"CHITRAKOOT","Madhya Pradesh",2785,1771,0,4556,"860 ","187076 ",100.00,"187076 ",100.00,100601,86475,0,187076
"RAIGAON","Madhya Pradesh",2570,2971,0,5541,"898 ","186500 ",100.00,"186500 ",100.00,98279,88218,3,186500
"SATNA","Madhya Pradesh",3157,1862,0,5019,"878 ","223560 ",100.00,"223560 ",100.00,119020,104532,8,223560
"NAGOD","Madhya Pradesh",2951,1774,0,4725,"923 ","194961 ",100.00,"194961 ",100.00,101402,93557,2,194961
"MAIHAR","Madhya Pradesh",2377,1267,0,3644,"898 ","214203 ",100.00,"214203 ",100.00,112865,101333,5,214203
"AMARPATAN","Madhya Pradesh",3252,1857,0,5109,"935 ","206337 ",100.00,"206337 ",100.00,106608,99727,2,206337
"RAMPUR BAGHELAN","Madhya Pradesh",3430,1919,0,5349,"896 ","219632 ",100.00,"219632 ",100.00,115859,103772,1,219632
"SIRMOUR","Madhya Pradesh",2785,1986,0,4771,"871 ","181328 ",100.00,"181328 ",100.00,96926,84402,0,181328
"SEMARIYA","Madhya Pradesh",2754,1704,0,4458,"873 ","181676 ",100.00,"181676 ",100.00,97009,84667,0,181676
"TEONTHAR","Madhya Pradesh",2878,1894,0,4772,"867 ","178454 ",100.00,"178454 ",100.00,95599,82855,0,178454
"MAUGANJ","Madhya Pradesh",2919,1726,0,4645,"880 ","186960 ",100.00,"186960 ",100.00,99448,87512,0,186960
"DEOTALAB","Madhya Pradesh",2872,1602,0,4474,"883 ","200283 ",100.00,"200283 ",100.00,106376,93907,0,200283
"MANGAWAN","Madhya Pradesh",2921,1814,0,4735,"886 ","206057 ",100.00,"206057 ",100.00,109283,96774,0,206057
"REWA","Madhya Pradesh",2556,1702,0,4258,"889 ","194313 ",100.00,"194313 ",100.00,102885,91428,0,194313
"GURH","Madhya Pradesh",3096,2001,0,5097,"891 ","193176 ",100.00,"193176 ",100.00,102168,91008,0,193176
"CHURHAT","Madhya Pradesh",3751,2119,0,5870,"891 ","215120 ",100.00,"215120 ",100.00,113741,101369,10,215120
"SIDHI","Madhya Pradesh",4136,3019,0,7155,"898 ","211659 ",100.00,"211659 ",100.00,111526,100132,1,211659
"SIHAWAL","Madhya Pradesh",3577,2472,0,6049,"891 ","212948 ",100.00,"212948 ",100.00,112618,100327,3,212948
"CHITRANGI","Madhya Pradesh",4688,4682,0,9370,"899 ","213440 ",100.00,"213440 ",100.00,112423,101015,2,213440
"SINGAROULI","Madhya Pradesh",3241,2242,1,5484,"825 ","204653 ",100.00,"204653 ",100.00,112117,92528,8,204653
"DEVSAR","Madhya Pradesh",3145,2913,0,6058,"919 ","202556 ",100.00,"202556 ",100.00,105533,97021,2,202556
"DHOUHANI","Madhya Pradesh",4537,4015,0,8552,"926 ","214460 ",100.00,"214460 ",100.00,111320,103128,12,214460
"BEOHARI","Madhya Pradesh",4311,6680,0,10991,"948 ","242563 ",100.00,"242563 ",100.00,124534,118029,0,242563
"JAISINGHNAGAR","Madhya Pradesh",3207,2499,1,5707,"948 ","222938 ",100.00,"222938 ",100.00,114470,108464,4,222938
"JAITPUR","Madhya Pradesh",2967,2043,0,5010,"940 ","220850 ",100.00,"220850 ",100.00,113867,106981,2,220850
"KOTAMA","Madhya Pradesh",2106,1152,0,3258,"895 ","142702 ",100.00,"142702 ",100.00,75315,67375,12,142702
"ANUPPUR","Madhya Pradesh",2555,3411,0,5966,"935 ","164261 ",100.00,"164261 ",100.00,84898,79348,15,164261
"PUSPRAJGARH","Madhya Pradesh",2285,2002,0,4287,"976 ","179106 ",100.00,"179106 ",100.00,90637,88460,9,179106
"BANDHAVGARH","Madhya Pradesh",4951,4477,1,9429,"928 ","193537 ",100.00,"193537 ",100.00,100388,93144,5,193537
"MANAPUR","Madhya Pradesh",7424,7427,1,14852,"946 ","219350 ",100.00,"219350 ",100.00,112705,106644,2,219351
"BADWARA","Madhya Pradesh",3929,2814,2,6745,"907 ","209558 ",100.00,"209558 ",100.00,109899,99654,5,209558
"VIJAYRAGHAVGARH","Madhya Pradesh",3815,2293,0,6108,"901 ","197901 ",100.00,"197901 ",100.00,104124,93776,0,197900
"MUDWARA","Madhya Pradesh",3467,2486,1,5954,"917 ","217775 ",100.00,"217775 ",100.00,113597,104169,9,217775
"BAHORIBAND","Madhya Pradesh",3429,2204,0,5633,"922 ","207367 ",100.00,"207367 ",100.00,107914,99444,9,207367
"PATAN","Madhya Pradesh",3269,1979,0,5248,"890 ","223107 ",100.00,"223107 ",100.00,118072,105030,5,223107
"BARGI","Madhya Pradesh",2223,1196,0,3419,"892 ","203579 ",100.00,"203579 ",100.00,107604,95962,13,203579
"JABALPUR EAST","Madhya Pradesh",2269,1579,0,3848,"894 ","216895 ",100.00,"216895 ",100.00,114502,102377,16,216895
"JABALPUR NORTH","Madhya Pradesh",1945,1687,0,3632,"911 ","206804 ",100.00,"206804 ",100.00,108220,98579,5,206804
"JABALPUR CANTT","Madhya Pradesh",1874,1416,0,3290,"920 ","190839 ",100.00,"190839 ",100.00,99374,91465,0,190839
"JABALPUR WEST","Madhya Pradesh",2424,1802,0,4226,"921 ","223273 ",100.00,"223273 ",100.00,116209,107062,2,223273
"PANAGAR","Madhya Pradesh",2114,1180,0,3294,"871 ","223333 ",100.00,"223333 ",100.00,119347,103948,38,223333
"SIHORA","Madhya Pradesh",2108,1322,0,3430,"935 ","200221 ",100.00,"200221 ",100.00,103497,96723,1,200221
"SHAHPURA","Madhya Pradesh",2743,2205,0,4948,"996 ","233602 ",100.00,"233602 ",100.00,117015,116584,3,233602
"DINDORI","Madhya Pradesh",3256,2777,0,6033,"986 ","224411 ",100.00,"224411 ",100.00,113008,111394,9,224411
"BICHHIYA","Madhya Pradesh",2899,2313,0,5212,"998 ","227402 ",100.00,"227402 ",100.00,113835,113567,0,227402
"NIWAS","Madhya Pradesh",2644,1885,0,4529,"993 ","226266 ",100.00,"226266 ",100.00,113519,112745,2,226266
"MANDLA","Madhya Pradesh",3074,2239,0,5313,"973 ","234849 ",100.00,"234849 ",100.00,119028,115820,1,234849
"BAIHAR","Madhya Pradesh",3068,2631,1,5700,"1004 ","203368 ",100.00,"203368 ",100.00,101455,101911,2,203368
"LANJI","Madhya Pradesh",2555,1592,0,4147,"948 ","209855 ",100.00,"209855 ",100.00,107750,102104,1,209855
"PARASWADA","Madhya Pradesh",3005,2045,0,5050,"991 ","189325 ",100.00,"189325 ",100.00,95096,94225,4,189325
"BALAGHAT","Madhya Pradesh",3040,2458,0,5498,"987 ","201956 ",100.00,"201956 ",100.00,101644,100308,2,201954
"WARASEONI","Madhya Pradesh",2850,2003,0,4853,"987 ","177480 ",100.00,"177480 ",100.00,89337,88143,0,177480
"KATANGI","Madhya Pradesh",2637,1953,0,4590,"980 ","176205 ",100.00,"176205 ",100.00,88992,87202,11,176205
"BARGHAT","Madhya Pradesh",4099,3241,0,7340,"984 ","210216 ",100.00,"210216 ",100.00,105946,104267,3,210216
"SEONI","Madhya Pradesh",4682,3398,0,8080,"935 ","231870 ",100.00,"231870 ",100.00,119818,112049,3,231870
"KEOLARI","Madhya Pradesh",4443,3465,0,7908,"947 ","221499 ",100.00,"221499 ",100.00,113771,107727,1,221499
"LAKHANADON","Madhya Pradesh",4319,3121,0,7440,"941 ","244702 ",100.00,"244702 ",100.00,126054,118647,1,244702
"GOTEGAON","Madhya Pradesh",2484,1329,0,3813,"895 ","185763 ",100.00,"185763 ",100.00,98019,87744,0,185763
"NARSINGPUR","Madhya Pradesh",2425,3329,0,5754,"913 ","201621 ",100.00,"201621 ",100.00,105373,96248,0,201621
"TENDUKHEDA","Madhya Pradesh",2335,1504,0,3839,"889 ","159358 ",100.00,"159358 ",100.00,84339,75019,0,159358
"GADARWARA","Madhya Pradesh",2613,2999,0,5612,"889 ","176926 ",100.00,"176926 ",100.00,93640,83286,0,176926
"JUNNARDEO","Madhya Pradesh",2747,2127,0,4874,"934 ","196636 ",100.00,"196636 ",100.00,101683,94953,0,196636
"AMARWARA","Madhya Pradesh",4113,3477,0,7590,"983 ","217051 ",100.00,"217051 ",100.00,109461,107585,5,217051
"CHURAI","Madhya Pradesh",3908,2851,1,6760,"910 ","181145 ",100.00,"181145 ",100.00,94849,86289,7,181145
"SAUSAR","Madhya Pradesh",3245,2254,0,5499,"901 ","180176 ",100.00,"180176 ",100.00,94756,85416,4,180176
"CHHINDWARA","Madhya Pradesh",3756,2698,0,6454,"945 ","232562 ",100.00,"232562 ",100.00,119588,112968,6,232562
"PARASIYA","Madhya Pradesh",3279,2435,0,5714,"939 ","190358 ",100.00,"190358 ",100.00,98160,92192,6,190358
"PANDHURNA","Madhya Pradesh",3553,2859,0,6412,"931 ","182724 ",100.00,"182724 ",100.00,94632,88091,1,182724
"MULTAI","Madhya Pradesh",3814,3043,0,6857,"909 ","198140 ",100.00,"198140 ",100.00,103785,94348,7,198140
"AMLA","Madhya Pradesh",3509,2678,1,6188,"901 ","201275 ",100.00,"201275 ",100.00,105861,95411,3,201275
"BETUL","Madhya Pradesh",3656,2983,0,6639,"921 ","211729 ",100.00,"211729 ",100.00,110218,101499,12,211729
"GHODADONGRI","Madhya Pradesh",4220,3755,0,7975,"953 ","209921 ",100.00,"209921 ",100.00,107497,102418,6,209921
"BHAINSDEHI","Madhya Pradesh",3669,1200,0,4869,"938 ","213361 ",100.00,"213361 ",100.00,110105,103254,2,213361
"TIMARNI","Madhya Pradesh",3503,2739,0,6242,"902 ","161209 ",100.00,"161209 ",100.00,84769,76440,0,161209
"HARDA","Madhya Pradesh",3955,2512,0,6467,"896 ","202201 ",100.00,"202201 ",100.00,106651,95550,0,202201
"SEONI MALWA","Madhya Pradesh",3718,2211,0,5929,"878 ","204683 ",100.00,"204683 ",100.00,108997,95686,0,204683
"HOSHANGABAD","Madhya Pradesh",2885,2106,0,4991,"890 ","195792 ",100.00,"195792 ",100.00,103616,92170,6,195792
"SOHAGPUR","Madhya Pradesh",3895,2155,0,6050,"864 ","206078 ",100.00,"206078 ",100.00,110539,95538,1,206078
"PIPARIYA","Madhya Pradesh",2880,1707,0,4587,"880 ","193419 ",100.00,"193419 ",100.00,102893,90523,3,193419
"UDAIPURA","Madhya Pradesh",3009,1306,2,4317,"848 ","218217 ",100.00,"218217 ",100.00,118113,100104,2,218219
"BHOJPUR","Madhya Pradesh",3740,2110,0,5850,"840 ","222512 ",100.00,"222512 ",100.00,120917,101593,2,222512
"SANCHI (SC)","Madhya Pradesh",4186,2570,0,6756,"843 ","225440 ",100.00,"225440 ",100.00,122335,103101,4,225440
"SILWANI","Madhya Pradesh",3181,2058,0,5239,"854 ","187703 ",100.00,"187703 ",100.00,101256,86443,4,187703
"VIDISHA","Madhya Pradesh",3557,2307,0,5864,"881 ","190581 ",100.00,"190581 ",100.00,101321,89258,2,190581
"BASODA","Madhya Pradesh",3595,2906,1,6502,"876 ","178517 ",100.00,"178517 ",100.00,95179,83334,4,178517
"KURWAI (SC)","Madhya Pradesh",4025,3753,0,7778,"870 ","198965 ",100.00,"198965 ",100.00,106388,92577,0,198965
"SIRONJ","Madhya Pradesh",5691,4111,0,9802,"850 ","187421 ",100.00,"187421 ",100.00,101294,86125,2,187421
"SHAMSHABAD","Madhya Pradesh",4303,3319,0,7622,"851 ","168314 ",100.00,"168314 ",100.00,90908,77405,1,168314
"BERASIA","Madhya Pradesh",4565,2583,2,7150,"873 ","197463 ",100.00,"197463 ",100.00,105438,92021,5,197464
"BHOPAL UTTAR","Madhya Pradesh",2651,1838,0,4489,"930 ","230093 ",100.00,"230093 ",100.00,119199,110890,4,230093
"NARELA","Madhya Pradesh",3650,2515,0,6165,"871 ","283101 ",100.00,"283101 ",100.00,151306,131785,10,283101
"BHOPAL DAKSHINA-PASHCHIM","Madhya Pradesh",3232,2254,0,5486,"878 ","209083 ",100.00,"209083 ",100.00,111311,97767,5,209083
"BHOPAL MADHYA","Madhya Pradesh",2586,1834,0,4420,"905 ","227410 ",100.00,"227410 ",100.00,119379,108018,13,227410
"GOVINDPURA","Madhya Pradesh",4456,3043,2,7501,"867 ","310417 ",100.00,"310417 ",100.00,166272,144131,16,310419
"HUZUR","Madhya Pradesh",4271,2410,0,6681,"854 ","267743 ",100.00,"267743 ",100.00,144433,123299,11,267743
"BUDHNI","Madhya Pradesh",5938,5132,0,11070,"899 ","229279 ",100.00,"229279 ",100.00,120732,108544,3,229279
"ASHTA","Madhya Pradesh",10456,9943,1,20400,"922 ","230384 ",100.00,"230384 ",100.00,119843,110538,3,230384
"ICHHAWAR","Madhya Pradesh",9622,9303,0,18925,"914 ","188685 ",100.00,"188685 ",100.00,98601,90082,2,188685
"SEHORE","Madhya Pradesh",7201,6090,0,13291,"922 ","188734 ",100.00,"188734 ",100.00,98214,90514,5,188733
"NARSINGHGARH","Madhya Pradesh",4493,3534,0,8027,"924 ","198167 ",100.00,"198167 ",100.00,102984,95182,1,198167
"BIAORA","Madhya Pradesh",4920,3645,0,8565,"907 ","204373 ",100.00,"204373 ",100.00,107149,97224,0,204373
"RAJGARH","Madhya Pradesh",4428,6785,0,11213,"952 ","199267 ",100.00,"199267 ",100.00,102083,97178,6,199267
"KHILCHIPUR","Madhya Pradesh",3722,2915,0,6637,"920 ","198471 ",100.00,"198471 ",100.00,103369,95101,1,198471
"SARANGPUR","Madhya Pradesh",3279,2070,0,5349,"922 ","172078 ",100.00,"172078 ",100.00,89536,82541,1,172078
"SUSNER","Madhya Pradesh",4275,3057,0,7332,"910 ","197843 ",99.00,"198143 ",100.00,103716,94421,6,198143
"AGAR","Madhya Pradesh",3508,2652,1,6161,"920 ","191540 ",100.00,"191540 ",100.00,99736,91797,7,191540
"SHAJAPUR","Madhya Pradesh",4932,96140,3,101075,"1786 ","298998 ",100.00,"298998 ",100.00,107312,191683,6,299001
"SHUJALPUR","Madhya Pradesh",4384,2693,0,7077,"908 ","179527 ",100.00,"179527 ",100.00,94093,85431,3,179527
"KALAPIPAL","Madhya Pradesh",4869,3397,0,8266,"901 ","186112 ",100.00,"186112 ",100.00,97918,88193,1,186112
"SONKATCH","Madhya Pradesh",3774,2220,1,5995,"923 ","199841 ",100.00,"199841 ",100.00,103903,95936,2,199841
"DEWAS","Madhya Pradesh",3828,2509,0,6337,"915 ","231043 ",100.00,"231043 ",100.00,120654,110384,5,231043
"HATPIPLIYA","Madhya Pradesh",3531,1899,0,5430,"913 ","174368 ",100.00,"174368 ",100.00,91154,83213,1,174368
"KHATEGAON","Madhya Pradesh",4018,2356,0,6374,"883 ","188559 ",100.00,"188559 ",100.00,100140,88415,4,188559
"BAGLI","Madhya Pradesh",3765,2619,0,6384,"908 ","204356 ",100.00,"204356 ",100.00,107093,97256,7,204356
"MANDHATA","Madhya Pradesh",3348,2514,0,5862,"912 ","184032 ",100.00,"184032 ",100.00,96264,87768,0,184032
"HARSUD","Madhya Pradesh",2781,2049,0,4830,"932 ","190421 ",100.00,"190421 ",100.00,98580,91835,6,190421
"KHANDWA","Madhya Pradesh",3411,5101,0,8512,"947 ","237648 ",100.00,"237648 ",100.00,122042,115595,11,237648
"PANDHANA","Madhya Pradesh",3733,2472,0,6205,"925 ","231592 ",100.00,"231592 ",100.00,120330,111260,2,231592
"NEPANAGAR","Madhya Pradesh",4128,3360,1,7489,"937 ","220403 ",100.00,"220403 ",100.00,113793,106600,11,220404
"BURHANPUR","Madhya Pradesh",3821,2326,0,6147,"926 ","268145 ",100.00,"268145 ",100.00,139249,128886,10,268145
"BHIKANGAON","Madhya Pradesh",5454,5015,0,10469,"950 ","203365 ",100.00,"203365 ",100.00,104305,99059,1,203365
"BADWAHA","Madhya Pradesh",3571,2357,0,5928,"938 ","195916 ",100.00,"195916 ",100.00,101113,94803,0,195916
"MAHESHWAR","Madhya Pradesh",3500,2296,0,5796,"966 ","195893 ",100.00,"195893 ",100.00,99662,96228,3,195893
"KASRAWAD","Madhya Pradesh",4223,3055,0,7278,"942 ","195483 ",100.00,"195483 ",100.00,100644,94836,3,195483
"KHARGONE","Madhya Pradesh",3630,2483,0,6113,"930 ","201062 ",100.00,"201062 ",100.00,104165,96897,0,201062
"BHAGWANPURA","Madhya Pradesh",5179,5559,0,10738,"966 ","210558 ",100.00,"210558 ",100.00,107099,103459,0,210558
"SENDHWA (S.T.)","Madhya Pradesh",6058,5824,0,11882,"959 ","232779 ",100.00,"232779 ",100.00,118801,113973,5,232779
"RAJPUR (S.T.)","Madhya Pradesh",5072,4293,0,9365,"968 ","215943 ",100.00,"215943 ",100.00,109725,106215,3,215943
"PANSEMAL (S.T.)","Madhya Pradesh",6307,6923,2,13232,"994 ","211152 ",100.00,"211152 ",100.00,105896,105251,5,211152
"BARWANI (S.T.)","Madhya Pradesh",6307,6192,0,12499,"978 ","225132 ",100.00,"225132 ",100.00,113844,111282,6,225132
"ALIRAJPUR","Madhya Pradesh",4432,3858,0,8290,"963 ","210075 ",100.00,"210075 ",100.00,107025,103049,1,210075
"JOBAT","Madhya Pradesh",5003,4531,0,9534,"983 ","243275 ",100.00,"243275 ",100.00,122655,120620,0,243275
"JHABUA","Madhya Pradesh",5028,4604,0,9632,"980 ","242822 ",100.00,"242822 ",100.00,122663,120154,5,242822
"THANDLA","Madhya Pradesh",4796,4380,1,9177,"986 ","212352 ",100.00,"212352 ",100.00,106927,105420,5,212352
"PETLAWAD","Madhya Pradesh",3678,3277,0,6955,"986 ","222164 ",100.00,"222164 ",100.00,111842,110318,4,222164
"SARDARPUR","Madhya Pradesh",4749,4229,1,8979,"985 ","191809 ",100.00,"191809 ",100.00,96604,95198,7,191809
"Gandhwani","Madhya Pradesh",7432,13853,1,21286,"1038 ","216418 ",100.00,"216418 ",100.00,106170,110242,6,216418
"KUKSHI","Madhya Pradesh",4387,3910,0,8297,"968 ","207438 ",100.00,"207438 ",100.00,105377,102053,8,207438
"MANAWAR","Madhya Pradesh",4315,3629,3,7947,"963 ","203213 ",100.00,"203213 ",100.00,103527,99680,7,203214
"DHARAMPURI","Madhya Pradesh",4664,3908,0,8572,"946 ","186239 ",100.00,"186239 ",100.00,95713,90525,1,186239
"DHAR","Madhya Pradesh",3657,2209,0,5866,"851 ","239846 ",100.00,"239846 ",100.00,129554,110281,11,239846
"BADNAWAR","Madhya Pradesh",4217,3033,0,7250,"981 ","182090 ",100.00,"182090 ",100.00,91936,90154,0,182090
"DEPALPUR","Madhya Pradesh",6804,4351,1,11156,"925 ","208710 ",100.00,"208710 ",100.00,108438,100269,3,208710
"INDORE-1","Madhya Pradesh",7283,5158,0,12441,"878 ","315349 ",100.00,"315349 ",100.00,167932,147410,6,315348
"INDORE-2","Madhya Pradesh",6058,4156,0,10214,"888 ","300825 ",100.00,"300825 ",100.00,159346,141471,8,300825
"INDORE-3","Madhya Pradesh",4073,2930,0,7003,"936 ","193455 ",100.00,"193455 ",100.00,99934,93501,20,193455
"Indore-4","Madhya Pradesh",5287,3874,0,9161,"946 ","238159 ",100.00,"238159 ",100.00,122382,115769,8,238159
"INDORE-5","Madhya Pradesh",7236,4895,0,12131,"918 ","329554 ",100.00,"329554 ",100.00,171806,157737,11,329554
"DR.AMBEDKAR NAGAR -Mhow","Madhya Pradesh",6918,4683,0,11601,"918 ","228959 ",100.00,"228959 ",100.00,119401,109552,6,228959
"RAU","Madhya Pradesh",6769,4360,1,11130,"914 ","247128 ",100.00,"247128 ",100.00,129141,117981,6,247128
"SANWER","Madhya Pradesh",6715,3955,1,10671,"907 ","216368 ",100.00,"216368 ",100.00,113431,102931,6,216368
"NAGADA - KHACHAROD","Madhya Pradesh",3401,2069,0,5470,"925 ","191904 ",100.00,"191904 ",100.00,99672,92222,10,191904
"MAHIDPUR","Madhya Pradesh",3250,2107,0,5357,"918 ","178959 ",100.00,"178959 ",100.00,93283,85676,0,178959
"TARANA","Madhya Pradesh",2769,1478,0,4247,"915 ","163099 ",100.00,"163099 ",100.00,85180,77917,2,163099
"GHATIYA","Madhya Pradesh",2966,1588,0,4554,"922 ","186357 ",100.00,"186357 ",100.00,96960,89396,1,186357
"UJJAIN NORTH","Madhya Pradesh",2098,1477,0,3575,"940 ","201680 ",100.00,"201680 ",100.00,103977,97702,1,201680
"UJJAIN SOUTH","Madhya Pradesh",2470,1580,0,4050,"939 ","213880 ",100.00,"213880 ",100.00,110322,103551,7,213880
"BADNAGAR","Madhya Pradesh",3506,1708,0,5214,"919 ","172712 ",100.00,"172712 ",100.00,89980,82732,0,172712
"RATLAM RURAL","Madhya Pradesh",4007,2777,0,6784,"961 ","177669 ",100.00,"177669 ",100.00,90609,87056,4,177669
"RATLAM CITY","Madhya Pradesh",2724,1946,0,4670,"957 ","197830 ",100.00,"197830 ",100.00,101102,96728,0,197830
"SAILANA","Madhya Pradesh",3507,3402,0,6909,"995 ","173200 ",100.00,"173200 ",100.00,86826,86367,7,173200
"JAORA","Madhya Pradesh",4117,2442,1,6560,"950 ","198518 ",100.00,"198518 ",100.00,101815,96697,6,198518
"ALOTE","Madhya Pradesh",3764,2517,0,6281,"932 ","189882 ",100.00,"189882 ",100.00,98272,91601,9,189882
"MANDSOUR","Madhya Pradesh",3948,2524,0,6472,"943 ","224716 ",100.00,"224716 ",100.00,115643,109067,6,224716
"MALHARGARH","Madhya Pradesh",4115,2702,0,6817,"954 ","210025 ",100.00,"210025 ",100.00,107480,102542,3,210025
"SUWASRA","Madhya Pradesh",4097,2348,0,6445,"929 ","231664 ",100.00,"231664 ",100.00,120086,111574,4,231664
"GAROTH","Madhya Pradesh",3851,2410,0,6261,"935 ","213064 ",100.00,"213064 ",100.00,110129,102934,1,213064
"MANASA","Madhya Pradesh",2737,1550,0,4287,"930 ","171740 ",100.00,"171740 ",100.00,89004,82733,3,171740
"NEEMUCH","Madhya Pradesh",2734,1741,0,4475,"934 ","199505 ",100.00,"199505 ",100.00,103137,96365,3,199505
"JAWAD","Madhya Pradesh",2081,1258,0,3339,"932 ","157288 ",100.00,"157288 ",100.00,81419,75863,6,157288
"Akkalkuwa","Maharashtra",3245,2534,0,5779,"975 ","224965 ",95.00,"224768 ",94.00,119819,116812,0,236631
"Shahada","Maharashtra",2633,1723,0,4356,"957 ","265205 ",97.00,"263495 ",96.00,139371,133317,0,272688
"Nandurbar","Maharashtra",3113,1693,0,4806,"957 ","282656 ",94.00,"282236 ",93.00,153630,146984,0,300614
"Nawapur","Maharashtra",2522,1723,0,4245,"1009 ","248631 ",96.00,"248447 ",96.00,127938,129036,0,256974
"Sakri","Maharashtra",2235,1167,0,3402,"921 ","288078 ",98.00,"288014 ",98.00,152959,140914,0,293873
"Dhule Rural","Maharashtra",3224,1627,0,4851,"916 ","318371 ",95.00,"317797 ",95.00,173519,158859,0,332378
"Dhule City","Maharashtra",2533,1432,0,3965,"871 ","248331 ",93.00,"247444 ",93.00,142007,123702,0,265709
"Sindkheda","Maharashtra",3114,2067,0,5181,"958 ","272503 ",92.00,"272160 ",92.00,150439,144178,0,294617
"Shirpur","Maharashtra",3141,2242,0,5383,"956 ","272135 ",95.00,"271476 ",95.00,145550,139119,0,284669
"Chopda","Maharashtra",3080,1688,0,4768,"911 ","268839 ",99.00,"268834 ",99.00,140679,128217,0,268896
"Raver","Maharashtra",2319,1198,0,3517,"883 ","259472 ",97.00,"258297 ",97.00,141132,124627,0,265759
"Bhusawal","Maharashtra",2162,965,0,3127,"862 ","253308 ",97.00,"252532 ",97.00,139769,120439,4,260212
"Jalgaon City","Maharashtra",2500,1331,0,3831,"853 ","286765 ",96.00,"285356 ",95.00,160767,137083,10,297860
"Jalgaon Rural","Maharashtra",2900,1384,0,4284,"886 ","264475 ",96.00,"262394 ",95.00,145409,128787,0,274196
"Amalner","Maharashtra",1730,865,0,2595,"890 ","251488 ",98.00,"251012 ",98.00,135344,120474,0,255818
"Erandol","Maharashtra",2649,1264,0,3913,"898 ","240151 ",96.00,"239471 ",96.00,131111,117795,0,248906
"Chalisgaon","Maharashtra",2314,1197,0,3511,"861 ","299097 ",96.00,"297155 ",96.00,166261,143106,0,309367
"Pachora","Maharashtra",2666,1425,0,4091,"883 ","262729 ",95.00,"261012 ",95.00,145428,128403,0,273831
"Jamner","Maharashtra",2537,1222,0,3759,"906 ","260140 ",96.00,"258500 ",96.00,140747,127516,0,268263
"Muktainagar","Maharashtra",2872,1401,0,4273,"893 ","248960 ",97.00,"248075 ",96.00,135288,120815,0,256103
"Malkapur","Maharashtra",2430,1131,0,3561,"870 ","235878 ",97.00,"235114 ",96.00,129694,112834,0,242528
"Buldhana","Maharashtra",2261,1321,0,3582,"888 ","240297 ",91.00,"239443 ",91.00,138558,123082,0,261640
"Chikhli","Maharashtra",2696,1439,0,4135,"895 ","243146 ",95.00,"242092 ",94.00,134914,120767,0,255681
"Sindkhed Raja","Maharashtra",2443,1196,0,3639,"890 ","257221 ",94.00,"255745 ",93.00,143982,128111,0,272093
"Mehkar","Maharashtra",2116,1036,0,3152,"900 ","251581 ",92.00,"249828 ",92.00,142477,128294,0,270771
"Khamgaon","Maharashtra",2394,1250,0,3644,"874 ","245117 ",96.00,"244935 ",96.00,135839,118666,0,254505
"Jalgaon (Jamod)","Maharashtra",2456,1190,0,3646,"876 ","243158 ",95.00,"242482 ",95.00,135361,118543,0,253904
"Akot","Maharashtra",2706,1155,0,3861,"858 ","249157 ",95.00,"249087 ",95.00,140465,120449,0,260914
"Balapur","Maharashtra",2723,1161,0,3884,"889 ","254308 ",94.00,"253088 ",94.00,142334,126517,0,268851
"Akola West","Maharashtra",1687,924,0,2611,"907 ","236021 ",89.00,"233440 ",88.00,138341,125494,0,263835
"Akola East","Maharashtra",2132,1083,0,3215,"899 ","268353 ",93.00,"267048 ",92.00,151620,136339,1,287960
"Murtizapur","Maharashtra",2092,979,0,3071,"916 ","247139 ",88.00,"245445 ",87.00,145802,133498,0,279300
"Risod","Maharashtra",2229,1111,0,3340,"888 ","258104 ",92.00,"256864 ",91.00,148016,131429,0,279445
"Washim","Maharashtra",3117,1611,0,4728,"901 ","294945 ",94.00,"293310 ",93.00,164412,148091,0,312503
"Karanja","Maharashtra",2084,1071,0,3155,"904 ","262546 ",95.00,"261531 ",95.00,144027,130249,0,274276
"Dhamamgaon railway","Maharashtra",1415,1053,0,2468,"922 ","266627 ",95.00,"264869 ",95.00,144678,133450,0,278128
"Badnera","Maharashtra",1004,633,0,1637,"922 ","256498 ",86.00,"253466 ",85.00,153911,141843,0,295754
"Amravati","Maharashtra",1846,1042,0,2888,"899 ","238905 ",93.00,"237567 ",92.00,134800,121130,0,255930
"Teosa","Maharashtra",1940,959,0,2899,"909 ","244102 ",93.00,"241840 ",92.00,136398,124035,0,260433
"Daryapur","Maharashtra",2071,1038,0,3109,"884 ","266950 ",98.00,"266283 ",97.00,144329,127645,0,271974
"Melghat","Maharashtra",1784,1160,0,2944,"893 ","238163 ",96.00,"236934 ",95.00,130541,116565,0,247106
"Achalpur","Maharashtra",1410,794,0,2204,"877 ","239521 ",97.00,"238751 ",97.00,130455,114447,0,244902
"Morshi","Maharashtra",1235,629,0,1864,"883 ","251713 ",97.00,"250843 ",97.00,136567,120544,0,257111
"Arvi","Maharashtra",1784,1109,0,2893,"927 ","221576 ",91.00,"221366 ",91.00,125272,116153,0,241425
"Deoli","Maharashtra",2037,1215,0,3252,"899 ","225349 ",94.00,"224116 ",93.00,125661,112990,0,238651
"Hinganghat","Maharashtra",2444,1248,0,3692,"892 ","246364 ",97.00,"245638 ",96.00,133975,119509,0,253484
"Wardha","Maharashtra",2212,1850,0,4062,"941 ","234688 ",86.00,"231861 ",85.00,140376,132086,0,272462
"Katol","Maharashtra",1522,666,0,2188,"880 ","233813 ",97.00,"233113 ",97.00,127349,112045,0,239394
"Savner","Maharashtra",2217,1120,0,3337,"889 ","258631 ",98.00,"258008 ",98.00,138741,123300,0,262041
"Hingna","Maharashtra",1616,784,0,2400,"847 ","260265 ",95.00,"258143 ",94.00,147905,125243,0,273148
"Umred","Maharashtra",2018,881,0,2899,"907 ","271237 ",98.00,"270714 ",98.00,143751,130439,0,274190
"Nagpur South West","Maharashtra",1448,1133,0,2581,"962 ","279433 ",89.00,"276743 ",88.00,159741,153618,0,313359
"Nagpur South","Maharashtra",1597,1157,0,2754,"948 ","280212 ",87.00,"276722 ",86.00,164360,155780,0,320140
"Nagpur East","Maharashtra",2458,1419,0,3877,"886 ","274541 ",89.00,"269190 ",87.00,162560,143967,0,306527
"Nagpur central","Maharashtra",1419,1090,0,2509,"941 ","252398 ",91.00,"245713 ",88.00,142781,134383,0,277164
"Nagpur West","Maharashtra",1405,1031,0,2436,"946 ","281397 ",89.00,"277407 ",88.00,160753,151997,0,312750
"Nagpur North","Maharashtra",1408,975,0,2383,"931 ","277021 ",86.00,"271918 ",84.00,166196,154801,0,320997
"Kamthi","Maharashtra",2658,1450,0,4108,"922 ","320416 ",90.00,"313385 ",88.00,183841,169448,0,353289
"Ramtek","Maharashtra",1685,767,0,2452,"883 ","231245 ",95.00,"229868 ",95.00,128026,113109,0,241135
"Tumsar","Maharashtra",2603,1480,0,4083,"957 ","267847 ",98.00,"267790 ",98.00,139526,133479,0,273005
"Bhandara","Maharashtra",2540,1365,0,3905,"962 ","307857 ",94.00,"307761 ",94.00,166810,160469,0,327279
"Sakoli","Maharashtra",2677,1220,0,3897,"941 ","279126 ",97.00,"279037 ",97.00,148191,139429,0,287620
"Arjuni-morgaon","Maharashtra",2700,1604,0,4304,"961 ","225040 ",96.00,"224828 ",96.00,118458,113884,1,232343
"Tirora","Maharashtra",2582,1759,0,4341,"986 ","223305 ",96.00,"223170 ",96.00,116395,114788,0,231183
"Gondiya","Maharashtra",2499,1919,0,4418,"999 ","249640 ",89.00,"249417 ",89.00,139436,139273,0,278709
"Amgaon","Maharashtra",3001,2103,0,5104,"982 ","237735 ",97.00,"237089 ",97.00,122909,120725,0,243634
"Armori","Maharashtra",2075,1107,0,3182,"942 ","219367 ",95.00,"218761 ",94.00,118856,111970,0,230826
"Gadchiroli","Maharashtra",2946,1957,0,4903,"929 ","260255 ",97.00,"260221 ",97.00,138903,129107,0,268010
"Aheri","Maharashtra",2403,1381,0,3784,"942 ","198151 ",95.00,"198010 ",95.00,106781,100552,0,207333
"Rajura","Maharashtra",3449,1638,0,5087,"878 ","271681 ",95.00,"270014 ",94.00,151348,132908,0,284256
"Chandrapur","Maharashtra",2745,1817,0,4562,"909 ","293534 ",86.00,"289130 ",85.00,177392,161283,0,338675
"Ballarpur","Maharashtra",2395,1179,0,3574,"926 ","265752 ",90.00,"261427 ",88.00,152929,141561,0,294490
"Brahmapuri","Maharashtra",2406,1064,0,3470,"956 ","234709 ",95.00,"233773 ",95.00,125580,120091,0,245671
"Chimur","Maharashtra",2746,1262,0,4008,"934 ","242941 ",95.00,"242768 ",95.00,132020,123254,0,255274
"Warora","Maharashtra",2200,1110,0,3310,"894 ","241373 ",90.00,"237732 ",88.00,141593,126542,0,268135
"Wani","Maharashtra",2614,1111,0,3725,"889 ","245339 ",95.00,"243497 ",94.00,136015,120879,0,256894
"Ralegaon","Maharashtra",2140,1366,0,3506,"904 ","244833 ",95.00,"243399 ",95.00,134266,121391,0,255657
"Yavatmal","Maharashtra",1637,823,0,2460,"919 ","271771 ",85.00,"267953 ",84.00,166131,152664,0,318795
"Digras","Maharashtra",3123,1518,0,4641,"881 ","276762 ",98.00,"276237 ",97.00,149906,132065,0,281971
"Arni","Maharashtra",2136,1112,0,3248,"904 ","262977 ",96.00,"261734 ",96.00,142732,129004,0,271736
"Pusad","Maharashtra",4068,1727,0,5795,"887 ","249085 ",91.00,"245541 ",90.00,143858,127608,0,271466
"Umarkhed","Maharashtra",3962,1734,0,5696,"892 ","253967 ",94.00,"250432 ",93.00,142164,126840,0,269004
"Kinwat","Maharashtra",2386,1149,0,3535,"906 ","218765 ",93.00,"217043 ",93.00,122260,110751,1,233012
"Hadgaon","Maharashtra",2192,1041,0,3233,"882 ","240595 ",94.00,"239298 ",93.00,135794,119830,0,255624
"Bhokar","Maharashtra",2648,1493,0,4141,"899 ","235948 ",94.00,"234404 ",94.00,131141,117908,3,249052
"Nanded North","Maharashtra",2128,1404,0,3532,"903 ","256950 ",82.00,"249948 ",80.00,163238,147413,0,310651
"Nanded South","Maharashtra",1740,953,0,2693,"912 ","246652 ",85.00,"239906 ",83.00,150702,137451,0,288153
"Loha","Maharashtra",2361,1376,0,3737,"904 ","234105 ",93.00,"231181 ",92.00,130862,118258,0,249120
"Naigaon","Maharashtra",2696,1605,0,4301,"939 ","253206 ",94.00,"250314 ",93.00,138508,130090,0,268598
"Deglur","Maharashtra",2953,1356,0,4309,"936 ","258361 ",92.00,"253327 ",90.00,144391,135150,0,279541
"Mukhed","Maharashtra",3540,1447,0,4987,"917 ","245151 ",92.00,"242202 ",91.00,138393,126945,0,265338
"Basmath","Maharashtra",3122,1256,0,4378,"886 ","253214 ",98.00,"252803 ",98.00,135998,120487,0,256485
"Kalamnuri","Maharashtra",3399,1752,0,5151,"873 ","264969 ",96.00,"263799 ",96.00,146021,127502,0,273523
"Hingoli","Maharashtra",3160,1545,0,4705,"881 ","266538 ",96.00,"264675 ",95.00,147311,129708,0,277019
"Jintur","Maharashtra",4838,2397,0,7235,"909 ","297084 ",96.00,"294944 ",95.00,162017,147277,0,309294
"Parbhani","Maharashtra",2993,1699,0,4692,"877 ","253839 ",96.00,"252744 ",95.00,140544,123283,0,263827
"Gangakhed","Maharashtra",4633,2746,0,7379,"895 ","329148 ",94.00,"326689 ",93.00,183554,164192,0,347746
"Pathri","Maharashtra",4087,1995,0,6082,"902 ","302721 ",95.00,"299965 ",94.00,166844,150507,0,317351
"Partur","Maharashtra",2638,1389,0,4027,"887 ","244892 ",96.00,"242985 ",95.00,134868,119596,0,254464
"Ghansawangi","Maharashtra",3398,1639,0,5037,"911 ","252789 ",92.00,"252182 ",92.00,142942,130167,0,273109
"Jalna","Maharashtra",2199,1009,0,3208,"865 ","237578 ",86.00,"235974 ",85.00,147885,127886,0,275771
"Badnapur","Maharashtra",3490,1769,0,5259,"879 ","254839 ",95.00,"253573 ",95.00,142012,124835,0,266847
"Bhokardan","Maharashtra",3411,1628,0,5039,"869 ","243366 ",95.00,"242639 ",95.00,136172,118353,0,254525
"Sillod","Maharashtra",3666,1774,0,5440,"847 ","263171 ",99.00,"263135 ",99.00,142722,120833,0,263555
"Kannad","Maharashtra",3195,1372,0,4567,"869 ","264033 ",98.00,"263414 ",97.00,144014,125218,0,269232
"Phulambri","Maharashtra",3148,1466,0,4614,"852 ","266780 ",98.00,"264496 ",97.00,146180,124506,0,270686
"Aurangabad central","Maharashtra",2864,1876,0,4740,"906 ","251368 ",98.00,"250753 ",98.00,133496,120949,0,254445
"Aurangabad West","Maharashtra",2850,1680,0,4530,"855 ","240752 ",96.00,"239231 ",96.00,134051,114554,0,248605
"Aurangabad East","Maharashtra",2661,1652,0,4313,"867 ","230135 ",97.00,"229313 ",97.00,126644,109741,0,236385
"Paithan","Maharashtra",2834,1303,0,4137,"847 ","244723 ",98.00,"243089 ",97.00,135076,114473,0,249549
"Gangapur","Maharashtra",2909,1395,0,4304,"870 ","252486 ",96.00,"251724 ",96.00,139449,121299,0,260748
"Vaijapur","Maharashtra",3228,1489,0,4717,"894 ","253800 ",97.00,"252602 ",96.00,137727,123165,0,260892
"Nandgaon","Maharashtra",1847,877,0,2724,"901 ","264140 ",95.00,"262336 ",95.00,145162,130766,0,275928
"Malegaon central","Maharashtra",1786,1208,0,2994,"912 ","217175 ",93.00,"211725 ",91.00,121381,110722,0,232103
"Malegaon outer","Maharashtra",2215,1056,0,3271,"880 ","266080 ",94.00,"260691 ",92.00,150217,132192,0,282409
"Baglan","Maharashtra",1611,781,0,2392,"892 ","220168 ",93.00,"216340 ",91.00,124988,111526,0,236514
"Kalwan","Maharashtra",2543,1769,0,4312,"921 ","225448 ",97.00,"224401 ",97.00,120061,110546,0,230607
"Chandvad","Maharashtra",1878,743,0,2621,"882 ","239503 ",98.00,"239132 ",97.00,129753,114475,0,244228
"Yevla","Maharashtra",1764,599,0,2363,"885 ","255190 ",97.00,"254948 ",97.00,138548,122546,0,261094
"Sinnar","Maharashtra",2322,1053,0,3375,"886 ","249213 ",96.00,"246722 ",95.00,137481,121786,0,259267
"Niphad","Maharashtra",2131,1095,0,3226,"890 ","234748 ",99.00,"234333 ",99.00,125207,111457,0,236664
"Dindori","Maharashtra",1610,784,0,2394,"901 ","250733 ",98.00,"250084 ",98.00,133340,120174,0,253514
"Nashik East","Maharashtra",2130,1277,0,3407,"885 ","250273 ",89.00,"247197 ",88.00,148684,131560,0,280244
"Nashik central","Maharashtra",1888,1046,0,2934,"893 ","234777 ",86.00,"229986 ",84.00,143113,127811,0,270924
"Nashik West","Maharashtra",2989,1657,0,4646,"798 ","251716 ",88.00,"245413 ",86.00,157395,125528,0,282923
"Devlali","Maharashtra",2391,1126,0,3517,"885 ","210444 ",93.00,"207520 ",92.00,118976,105277,0,224253
"Igatpuri","Maharashtra",3161,1829,0,4990,"911 ","220886 ",96.00,"219950 ",96.00,119279,108674,0,227953
"Dahanu","Maharashtra",1964,926,0,2890,"966 ","215175 ",94.00,"210991 ",92.00,115506,111627,0,227133
"Vikramgad","Maharashtra",1969,1087,0,3056,"963 ","235369 ",98.00,"232557 ",96.00,122250,117721,0,239971
"Palghar","Maharashtra",2157,1317,0,3474,"935 ","217897 ",95.00,"213296 ",93.00,117708,110087,0,227795
"Boisar","Maharashtra",2103,1085,0,3188,"847 ","213126 ",89.00,"209385 ",87.00,129466,109671,0,239137
"Nalasopara","Maharashtra",2485,1666,0,4151,"810 ","256955 ",75.00,"252856 ",74.00,187796,152088,44,339928
"Vasai","Maharashtra",1980,1497,0,3477,"927 ","239607 ",87.00,"237610 ",86.00,142163,131725,0,273888
"Bhiwandi Rural (S.T.)","Maharashtra",2448,1553,0,4001,"884 ","219500 ",87.00,"214116 ",85.00,133496,117995,0,251491
"shahapur","Maharashtra",1553,823,0,2376,"919 ","209297 ",91.00,"203784 ",89.00,118716,109109,0,227825
"Bhiwandi West","Maharashtra",1098,580,0,1678,"610 ","169157 ",74.00,"165618 ",73.00,140318,85556,0,225874
"Bhiwandi East","Maharashtra",1636,895,0,2531,"602 ","182718 ",73.00,"178558 ",71.00,155372,93458,1,248831
"Kalyan West","Maharashtra",1555,997,0,2552,"875 ","223079 ",61.00,"205352 ",56.00,193969,169643,0,363612
"Murbad","Maharashtra",2320,1377,0,3697,"876 ","255849 ",78.00,"245233 ",75.00,172791,151309,0,324100
"Ambernath","Maharashtra",1559,933,0,2492,"841 ","236549 ",73.00,"224109 ",69.00,174439,146756,0,321195
"Ulhasnagar","Maharashtra",1952,1070,0,3022,"799 ","180174 ",57.00,"166448 ",52.00,174686,139536,4,314226
"Kalyan East","Maharashtra",1016,593,0,1609,"822 ","185870 ",63.00,"175409 ",59.00,160684,132106,3,292793
"Dombivali","Maharashtra",1327,1003,0,2330,"933 ","201480 ",62.00,"179917 ",55.00,167717,156537,0,324254
"Kalyan Rural","Maharashtra",1468,836,0,2304,"820 ","190997 ",61.00,"181439 ",58.00,170023,139380,0,309403
"Mira Bhayandar","Maharashtra",2487,1604,0,4091,"842 ","258801 ",81.00,"256153 ",80.00,172362,145201,0,317563
"Ovala - Majiwada","Maharashtra",2081,1297,0,3378,"803 ","241664 ",72.00,"236849 ",71.00,183990,147688,1,331679
"Kopri-Pachpakhadi","Maharashtra",2612,1617,0,4229,"798 ","246845 ",74.00,"239515 ",72.00,184832,147499,2,332333
"Thane","Maharashtra",1710,1187,0,2897,"875 ","241237 ",79.00,"235602 ",77.00,161539,141270,0,302809
"Mumbra-Kalwa","Maharashtra",1602,992,0,2594,"814 ","235105 ",73.00,"229584 ",72.00,175393,142806,0,318199
"Airoli","Maharashtra",2018,1174,0,3192,"740 ","238805 ",66.00,"231697 ",64.00,205160,151799,21,356980
"Belapur","Maharashtra",1843,1231,0,3074,"833 ","234832 ",67.00,"225983 ",64.00,191143,159215,0,350358
"Borivali","Maharashtra",2300,1786,0,4086,"925 ","248373 ",81.00,"236348 ",77.00,157494,145688,0,303182
"Dahisar","Maharashtra",1847,1320,0,3167,"865 ","233078 ",77.00,"215649 ",71.00,160717,139066,0,299783
"Magathane","Maharashtra",1931,1324,0,3255,"772 ","235970 ",79.00,"217899 ",73.00,168015,129761,0,297776
"Mulund","Maharashtra",2083,1679,0,3762,"905 ","250996 ",88.00,"239830 ",84.00,148211,134090,0,282301
"Vikhroli","Maharashtra",1520,1011,0,2531,"851 ","202462 ",83.00,"184193 ",75.00,131296,111677,0,242973
"Bhandup West","Maharashtra",2421,1449,0,3870,"778 ","245250 ",85.00,"227208 ",79.00,160766,125074,19,285859
"Jogeshwari East","Maharashtra",2038,1429,0,3467,"826 ","239771 ",87.00,"231857 ",84.00,149490,123540,0,273030
"Dindoshi","Maharashtra",2681,1533,0,4214,"689 ","231342 ",82.00,"223582 ",79.00,166704,114852,0,281556
"Kandivali East","Maharashtra",1995,1173,0,3168,"774 ","217005 ",86.00,"208407 ",83.00,141450,109452,0,250902
"Charkop","Maharashtra",1774,1179,0,2953,"802 ","231168 ",79.00,"217302 ",74.00,162133,130008,0,292141
"Malad West","Maharashtra",1902,1287,0,3189,"846 ","234106 ",83.00,"224087 ",79.00,152443,128917,1,281361
"Goregaon","Maharashtra",1858,1119,0,2977,"791 ","243359 ",75.00,"227465 ",70.00,179763,142140,0,321903
"Versova","Maharashtra",1505,1034,0,2539,"797 ","193789 ",68.00,"158620 ",56.00,157005,125116,0,282121
"Andheri West","Maharashtra",1762,1296,0,3058,"869 ","226122 ",77.00,"204136 ",69.00,157040,136389,0,293429
"Andheri East","Maharashtra",1582,1084,0,2666,"808 ","235135 ",86.00,"227902 ",83.00,151070,122008,0,273078
"Vile parle","Maharashtra",1315,940,0,2255,"879 ","226166 ",83.00,"212186 ",78.00,143819,126355,0,270174
"Chandivali","Maharashtra",1966,1112,0,3078,"685 ","301751 ",75.00,"279271 ",70.00,236600,162133,0,398733
"Ghatkopar West","Maharashtra",1912,1199,0,3111,"779 ","236863 ",82.00,"217214 ",75.00,161489,125806,50,287345
"Ghatkopar East","Maharashtra",1927,1295,0,3222,"865 ","212127 ",89.00,"202680 ",85.00,127493,110317,0,237810
"Mankhurd shivaji Nagar","Maharashtra",2106,959,0,3065,"687 ","211907 ",72.00,"191383 ",65.00,173596,119244,0,292840
"Anushakti Nagar","Maharashtra",2295,1411,0,3706,"805 ","209196 ",77.00,"191108 ",70.00,149565,120456,0,270021
"Chembur","Maharashtra",1836,1183,0,3019,"851 ","217407 ",81.00,"195283 ",73.00,143646,122180,2,265828
"Kurla","Maharashtra",1729,1050,0,2779,"767 ","221173 ",79.00,"200383 ",72.00,156657,120096,3,276756
"Kalina","Maharashtra",1527,985,0,2512,"792 ","208464 ",85.00,"195698 ",80.00,136218,107932,0,244150
"Vandre East","Maharashtra",1360,851,0,2211,"802 ","205916 ",81.00,"185922 ",73.00,140252,112429,0,252681
"Vandre West","Maharashtra",1451,1146,0,2597,"918 ","238757 ",94.00,"232368 ",91.00,132324,121442,1,253767
"Dharavi","Maharashtra",2296,1341,0,3637,"726 ","197377 ",86.00,"193519 ",84.00,132067,95851,0,227918
"Sion koliwada","Maharashtra",1691,1053,0,2744,"744 ","205989 ",85.00,"199368 ",82.00,138444,102967,0,241411
"Wadala","Maharashtra",4043,3091,0,7134,"886 ","177219 ",97.00,"173337 ",94.00,96795,85726,0,182521
"Mahim","Maharashtra",1312,1060,0,2372,"948 ","200004 ",90.00,"189397 ",85.00,113116,107192,18,220326
"Worli","Maharashtra",1410,915,0,2325,"767 ","230362 ",92.00,"228265 ",91.00,140967,108051,0,249018
"Shivadi","Maharashtra",1562,1092,0,2654,"793 ","228758 ",88.00,"222106 ",86.00,143523,113751,0,257274
"Byculla","Maharashtra",1746,1190,0,2936,"823 ","206650 ",96.00,"206077 ",96.00,117013,96260,7,213280
"Malabar hill","Maharashtra",1524,1155,0,2679,"876 ","228768 ",87.00,"225670 ",86.00,139619,122354,0,261973
"Mumbadevi","Maharashtra",1386,1005,0,2391,"773 ","193799 ",86.00,"192481 ",85.00,127038,98240,8,225286
"Colaba","Maharashtra",1274,791,0,2065,"696 ","201438 ",87.00,"199353 ",86.00,135870,94515,0,230385
"Panvel","Maharashtra",4076,2876,0,6952,"866 ","309250 ",87.00,"298840 ",84.00,189704,164283,1,353988
"Karjat","Maharashtra",3228,2028,0,5256,"910 ","226873 ",96.00,"225119 ",96.00,122516,111434,0,233950
"Uran","Maharashtra",2792,1927,0,4719,"949 ","233739 ",95.00,"231400 ",94.00,125380,118973,0,244353
"Pen","Maharashtra",3288,2142,0,5430,"954 ","260015 ",94.00,"257211 ",93.00,141110,134593,0,275703
"Alibag","Maharashtra",3149,2219,0,5368,"983 ","259394 ",96.00,"255798 ",94.00,136176,133847,0,270023
"Shrivardhan","Maharashtra",2903,1917,0,4820,"1042 ","226354 ",96.00,"225675 ",96.00,114307,119105,0,233412
"Mahad","Maharashtra",2991,1780,0,4771,"991 ","243718 ",94.00,"240375 ",93.00,129694,128514,0,258208
"Junnar","Maharashtra",2187,1239,0,3426,"920 ","263800 ",99.00,"263698 ",99.00,137692,126613,0,264305
"Ambegaon","Maharashtra",2107,1098,0,3205,"904 ","251888 ",99.00,"251533 ",99.00,132927,120200,0,253127
"Khed alandi","Maharashtra",2187,1056,0,3243,"887 ","264440 ",99.00,"264354 ",99.00,140514,124668,0,265182
"Shirur","Maharashtra",2695,1204,0,3899,"890 ","281452 ",96.00,"279140 ",95.00,154377,137321,0,291698
"Daund","Maharashtra",2199,1210,0,3409,"889 ","242132 ",95.00,"241283 ",94.00,134585,119612,0,254197
"Indapur","Maharashtra",2699,1466,0,4165,"882 ","254915 ",96.00,"253827 ",96.00,140274,123713,0,263987
"Baramati","Maharashtra",2373,1020,0,3393,"898 ","292873 ",99.00,"292858 ",99.00,154552,138745,0,293297
"Purandar","Maharashtra",1127,448,0,1575,"884 ","266128 ",97.00,"266055 ",97.00,144870,128087,0,272957
"Bhor","Maharashtra",2920,1371,0,4291,"873 ","295391 ",98.00,"294933 ",98.00,159743,139482,0,299225
"Maval","Maharashtra",2257,1319,0,3576,"914 ","265396 ",98.00,"265078 ",98.00,140179,128173,0,268352
"Chinchwad","Maharashtra",2971,1921,0,4892,"846 ","348671 ",80.00,"345735 ",79.00,234456,198403,1,432860
"Pimpri","Maharashtra",2020,1367,0,3387,"875 ","261475 ",73.00,"255478 ",71.00,189779,166049,0,355828
"Bhosari","Maharashtra",2870,1744,0,4614,"795 ","276096 ",85.00,"273376 ",84.00,179604,142708,0,322312
"VADGAON SHERI","Maharashtra",1660,914,0,2574,"898 ","293792 ",79.00,"290860 ",79.00,193561,173863,0,367424
"Shivajinagar","Maharashtra",1365,864,0,2229,"955 ","223441 ",85.00,"218416 ",83.00,133423,127431,0,260854
"Kothrud","Maharashtra",1718,1184,0,2902,"909 ","262076 ",84.00,"257576 ",82.00,162880,148029,0,310909
"Khadakwasala","Maharashtra",2501,1754,0,4255,"894 ","295287 ",78.00,"293554 ",78.00,197779,176789,0,374568
"Parvati","Maharashtra",2000,1217,0,3217,"924 ","265356 ",84.00,"262721 ",84.00,162262,149985,0,312247
"Hadapsar","Maharashtra",2109,1184,0,3293,"871 ","289252 ",79.00,"284380 ",77.00,195276,170107,0,365383
"Pune cantonment","Maharashtra",1158,682,0,1840,"937 ","214953 ",80.00,"208423 ",78.00,137104,128513,0,265617
"Kasba peth","Maharashtra",1190,686,0,1876,"990 ","238002 ",93.00,"233220 ",91.00,127841,126548,0,254389
"Akole","Maharashtra",3300,1951,0,5251,"883 ","229061 ",99.00,"228801 ",99.00,122675,108261,0,230936
"Sangamner","Maharashtra",3418,2166,0,5584,"908 ","241258 ",98.00,"240657 ",97.00,129038,117127,0,246165
"Shirdi","Maharashtra",3718,2194,0,5912,"912 ","239720 ",99.00,"239518 ",99.00,126470,115376,0,241846
"Kopargaon","Maharashtra",3508,2128,0,5636,"919 ","236635 ",99.00,"236607 ",99.00,123578,113531,0,237109
"Shrirampur","Maharashtra",2876,1529,0,4405,"912 ","258206 ",99.00,"258142 ",99.00,135215,123262,0,258477
"Nevasa","Maharashtra",2742,1137,0,3879,"876 ","229429 ",98.00,"228768 ",98.00,124115,108781,0,232896
"Shevgaon","Maharashtra",4139,2206,0,6345,"894 ","301780 ",99.00,"301331 ",99.00,160603,143577,0,304180
"Rahuri","Maharashtra",3527,1969,0,5496,"882 ","259942 ",98.00,"259249 ",98.00,140121,123593,0,263714
"Parner","Maharashtra",3545,1959,0,5504,"896 ","281899 ",99.00,"281195 ",98.00,150091,134546,0,284637
"Ahmednagar City","Maharashtra",2187,1405,0,3592,"911 ","244129 ",97.00,"242713 ",96.00,131268,119621,11,250900
"Shrigonda","Maharashtra",2883,1359,0,4242,"879 ","280052 ",98.00,"279551 ",98.00,150569,132416,0,282985
"Karjat jamkhed","Maharashtra",3491,1832,0,5323,"866 ","282736 ",98.00,"282059 ",98.00,153160,132706,0,285866
"Georai","Maharashtra",3196,1603,0,4799,"867 ","296032 ",97.00,"294352 ",97.00,162341,140802,0,303143
"Majalgaon","Maharashtra",3113,1516,0,4629,"865 ","274093 ",96.00,"272300 ",95.00,152116,131631,0,283747
"Beed","Maharashtra",2758,1194,0,3952,"846 ","265865 ",96.00,"264294 ",95.00,149194,126290,0,275484
"Ashti","Maharashtra",4539,2155,0,6694,"850 ","324499 ",98.00,"322971 ",97.00,178399,151672,0,330071
"Kaij","Maharashtra",2529,1297,0,3826,"874 ","303030 ",96.00,"301192 ",95.00,167644,146525,0,314169
"Parli","Maharashtra",2569,1286,0,3855,"861 ","259252 ",98.00,"258828 ",98.00,141468,121747,0,263215
"Latur Rural","Maharashtra",2719,1226,0,3945,"868 ","273065 ",96.00,"271072 ",95.00,151945,131823,0,283768
"Latur City","Maharashtra",2795,1413,0,4208,"875 ","285240 ",90.00,"283018 ",89.00,168486,147429,0,315915
"Ahmadpur","Maharashtra",3366,1350,0,4716,"854 ","271412 ",97.00,"271272 ",97.00,149921,128097,0,278018
"Udgir","Maharashtra",2522,1179,0,3701,"859 ","258332 ",98.00,"257910 ",98.00,140668,120900,0,261568
"Nilanga","Maharashtra",2761,1154,0,3915,"869 ","270607 ",98.00,"269847 ",98.00,147088,127809,0,274897
"Ausa","Maharashtra",2516,945,0,3461,"866 ","247573 ",99.00,"247497 ",99.00,133208,115349,0,248557
"Umarga","Maharashtra",4261,2043,0,6304,"862 ","264165 ",96.00,"263106 ",96.00,146341,126153,0,272494
"Tuljapur","Maharashtra",2421,1078,0,3499,"841 ","307111 ",97.00,"305332 ",96.00,171897,144535,7,316439
"Osmanabad","Maharashtra",2663,1035,0,3698,"858 ","294139 ",94.00,"292335 ",94.00,166704,142954,1,309659
"Paranda","Maharashtra",4230,2287,0,6517,"851 ","272791 ",96.00,"270010 ",95.00,152765,129940,0,282705
"Karmala","Maharashtra",1769,920,0,2689,"861 ","255729 ",96.00,"254658 ",95.00,143061,123220,0,266281
"Madha","Maharashtra",3566,1647,0,5213,"862 ","282989 ",98.00,"282756 ",98.00,153781,132611,0,286392
"Barshi","Maharashtra",2413,1374,0,3787,"893 ","272648 ",98.00,"271386 ",97.00,146745,131060,0,277805
"Mohol","Maharashtra",2904,1308,0,4212,"872 ","266978 ",96.00,"266237 ",95.00,148224,129215,0,277439
"Solapur City North","Maharashtra",2386,1490,0,3876,"947 ","236785 ",92.00,"233238 ",90.00,131641,124704,0,256345
"Solapur City central","Maharashtra",2296,1384,0,3680,"950 ","242886 ",93.00,"238087 ",91.00,133868,127115,0,260983
"Akkalkot","Maharashtra",2026,908,0,2934,"913 ","289481 ",93.00,"285853 ",92.00,162065,147953,0,310018
"Solapur South","Maharashtra",2666,1465,0,4131,"867 ","249679 ",90.00,"245390 ",88.00,148623,128803,0,277426
"Pandharpur","Maharashtra",3761,1975,0,5736,"884 ","278289 ",98.00,"277993 ",98.00,150007,132655,0,282662
"Sangola","Maharashtra",3116,1311,0,4427,"874 ","255131 ",98.00,"254743 ",98.00,138522,121121,0,259643
"Malshiras","Maharashtra",2605,1272,0,3877,"895 ","276908 ",97.00,"276527 ",97.00,149805,134002,0,283807
"Phaltan","Maharashtra",1832,855,0,2687,"918 ","286166 ",96.00,"285686 ",96.00,153961,141285,0,295246
"Wai","Maharashtra",2252,1198,0,3450,"960 ","296090 ",97.00,"295451 ",97.00,155058,148817,0,303875
"Koregaon","Maharashtra",1528,660,0,2188,"936 ","264314 ",94.00,"263553 ",93.00,144919,135648,0,280567
"Man","Maharashtra",2810,1300,0,4110,"928 ","293453 ",97.00,"292850 ",97.00,156077,144780,0,300857
"Karad North","Maharashtra",2037,987,0,3024,"946 ","260871 ",97.00,"260290 ",97.00,137494,130000,0,267494
"Karad South","Maharashtra",2304,1265,0,3569,"919 ","255054 ",95.00,"253018 ",94.00,139662,128296,0,267958
"Patan","Maharashtra",2583,1532,0,4115,"967 ","266725 ",98.00,"266447 ",97.00,138353,133772,0,272125
"Satara","Maharashtra",1869,925,0,2794,"978 ","281166 ",93.00,"277237 ",92.00,152171,148797,0,300968
"Dapoli","Maharashtra",2291,1440,0,3731,"1138 ","250896 ",98.00,"250626 ",98.00,119205,135663,0,254868
"Guhagar","Maharashtra",2370,1476,0,3846,"1158 ","217106 ",98.00,"216873 ",97.00,102591,118803,0,221394
"Chiplun","Maharashtra",1994,1185,0,3179,"1048 ","238645 ",98.00,"238132 ",98.00,118302,123930,0,242232
"Ratnagiri","Maharashtra",2496,1734,0,4230,"1036 ","247871 ",97.00,"247295 ",97.00,125214,129682,0,254896
"Rajapur","Maharashtra",1821,1217,0,3038,"1188 ","220593 ",97.00,"220061 ",96.00,103746,123240,0,226986
"Kankavli","Maharashtra",2452,1528,0,3980,"1050 ","211018 ",97.00,"210485 ",97.00,105541,110827,0,216368
"Kudal","Maharashtra",1681,1113,0,2794,"1028 ","187718 ",95.00,"186752 ",94.00,96935,99672,0,196607
"Sawantwadi","Maharashtra",1686,1082,0,2768,"985 ","207173 ",98.00,"206536 ",97.00,106179,104597,0,210776
"Chandgad","Maharashtra",3439,1903,0,5342,"978 ","289765 ",99.00,"289574 ",99.00,147796,144499,0,292295
"Radhanagari","Maharashtra",2773,1471,0,4244,"913 ","301430 ",99.00,"301405 ",99.00,157734,143974,0,301708
"Kagal","Maharashtra",3439,1558,0,4997,"950 ","291658 ",99.00,"291644 ",99.00,150008,142454,0,292462
"Kolhapur South","Maharashtra",2389,983,0,3372,"921 ","278135 ",95.00,"277258 ",94.00,152217,140157,0,292374
"Karvir","Maharashtra",3557,1218,0,4775,"892 ","277516 ",99.00,"276657 ",98.00,148077,132095,0,280172
"Kolhapur North","Maharashtra",1514,782,0,2296,"969 ","249615 ",94.00,"248971 ",94.00,134029,129823,0,263852
"Shahuwadi","Maharashtra",3626,1420,0,5046,"919 ","261618 ",99.00,"261540 ",99.00,136689,125605,0,262294
"Hatkanangle","Maharashtra",2787,917,0,3704,"921 ","291046 ",97.00,"289747 ",97.00,154667,142388,0,297055
"Ichalkaranji","Maharashtra",2092,908,0,3000,"899 ","261033 ",99.00,"260896 ",99.00,138517,124465,34,263016
"Shirol","Maharashtra",3033,1136,0,4169,"932 ","274128 ",97.00,"273982 ",97.00,144870,135082,0,279952
"Miraj","Maharashtra",1457,610,0,2067,"920 ","263620 ",92.00,"261015 ",91.00,148722,136885,0,285607
"Sangli","Maharashtra",1671,804,0,2475,"950 ","268855 ",86.00,"266009 ",85.00,158740,150866,10,309616
"Islampur","Maharashtra",2177,922,0,3099,"919 ","231148 ",96.00,"230284 ",95.00,125113,114986,0,240099
"Shirala","Maharashtra",2954,1149,0,4103,"917 ","264093 ",98.00,"263257 ",98.00,139543,127964,0,267507
"Palus-Kadegaon","Maharashtra",3168,1864,0,5032,"940 ","243334 ",99.00,"243111 ",99.00,126108,118513,0,244621
"Khanapur","Maharashtra",2605,1270,0,3875,"915 ","280745 ",98.00,"280199 ",98.00,148421,135808,0,284229
"Tasgaon-Kavathe Mahankal","Maharashtra",1925,615,0,2540,"908 ","247379 ",98.00,"246535 ",97.00,131975,119809,0,251784
"Jath","Maharashtra",2178,967,0,3145,"870 ","222171 ",96.00,"220284 ",95.00,123502,107493,0,230995
"Khundrakpam (GEN)","Manipur",289,229,0,518,"944 ","23532 ",100.00,"23532 ",100.00,12105,11427,0,23532
"Heingang (GEN)","Manipur",367,412,0,779,"1045 ","28000 ",98.00,"28291 ",100.00,13831,14460,0,28291
"Khurai (GEN)","Manipur",212,254,0,466,"1070 ","29092 ",100.00,"29092 ",100.00,14053,15039,0,29092
"Kshetrigao","Manipur",345,354,0,699,"1066 ","29722 ",100.00,"29722 ",100.00,14386,15336,0,29722
"Thongju","Manipur",99,115,0,214,"1082 ","27994 ",100.00,"27994 ",100.00,13443,14551,0,27994
"Keirao","Manipur",275,283,0,558,"1066 ","25048 ",100.00,"25048 ",100.00,12122,12926,0,25048
"Andro","Manipur",354,364,0,718,"1046 ","29254 ",100.00,"29254 ",100.00,14299,14955,0,29254
"Lamlai","Manipur",173,174,0,347,"978 ","24557 ",100.00,"24557 ",100.00,12412,12145,0,24557
"Thangmeiband","Manipur",256,204,0,460,"1097 ","26064 ",99.00,"26187 ",100.00,12490,13697,0,26187
"Uripok","Manipur",238,227,0,465,"1105 ","21414 ",99.00,"21545 ",100.00,10234,11311,0,21545
"Sagolband","Manipur",187,183,0,370,"1112 ","21698 ",99.00,"21821 ",100.00,10332,11489,0,21821
"Keishamthong","Manipur",217,224,0,441,"1134 ","24932 ",99.00,"25072 ",100.00,11751,13321,0,25072
"Singjamei","Manipur",154,156,0,310,"1125 ","18528 ",99.00,"18636 ",100.00,8768,9868,0,18636
"Yaiskul","Manipur",197,195,0,392,"1145 ","23692 ",100.00,"23692 ",100.00,11046,12646,0,23692
"Wangkhei","Manipur",295,252,0,547,"1078 ","31706 ",100.00,"31706 ",100.00,15257,16449,0,31706
"Sekmai","Manipur",335,307,0,642,"999 ","24702 ",99.00,"24839 ",100.00,12423,12416,0,24839
"Lamsang","Manipur",287,272,0,559,"987 ","27907 ",99.00,"28013 ",100.00,14097,13916,0,28013
"Konthoujam","Manipur",122,121,0,243,"1019 ","25948 ",99.00,"26051 ",100.00,12905,13146,0,26051
"Patsoi","Manipur",378,305,0,683,"1068 ","31143 ",99.00,"31317 ",100.00,15145,16172,0,31317
"Langthabal","Manipur",298,349,0,647,"1064 ","24663 ",99.00,"24831 ",100.00,12029,12802,0,24831
"Naoriya pakhanglakpa","Manipur",410,493,0,903,"1058 ","30557 ",99.00,"30738 ",100.00,14933,15805,0,30738
"Wangoi","Manipur",486,482,0,968,"1039 ","26077 ",99.00,"26312 ",100.00,12907,13405,0,26312
"Mayang imphal","Manipur",188,236,0,424,"1057 ","26711 ",99.00,"26840 ",100.00,13050,13790,0,26840
"Nambol","Manipur",475,443,0,918,"1041 ","28677 ",99.00,"28812 ",100.00,14117,14695,0,28812
"Oinam","Manipur",258,266,0,524,"1052 ","24480 ",99.00,"24580 ",100.00,11980,12600,0,24580
"Bishnupur","Manipur",232,271,0,503,"1061 ","27451 ",99.00,"27515 ",100.00,13353,14162,0,27515
"Moirang","Manipur",273,157,0,430,"1017 ","31601 ",99.00,"31683 ",100.00,15710,15973,0,31683
"Thanga","Manipur",86,82,0,168,"984 ","18979 ",99.00,"19020 ",100.00,9587,9433,0,19020
"Kumbi","Manipur",146,142,0,288,"995 ","23979 ",99.00,"24030 ",100.00,12045,11985,0,24030
"Lilong","Manipur",287,263,0,550,"1046 ","28275 ",99.00,"28390 ",100.00,13876,14514,0,28390
"Thoubal","Manipur",220,220,0,440,"1041 ","27331 ",99.00,"27473 ",100.00,13458,14015,0,27473
"Wangkhem","Manipur",373,372,0,745,"997 ","27405 ",99.00,"27584 ",100.00,13810,13774,0,27584
"Heirok","Manipur",312,332,0,644,"1038 ","27662 ",99.00,"27839 ",100.00,13657,14182,0,27839
"Wangjing tentha","Manipur",358,463,0,821,"1079 ","29945 ",99.00,"30172 ",100.00,14513,15659,0,30172
"Khangabok","Manipur",364,436,0,800,"1104 ","31889 ",99.00,"32117 ",100.00,15266,16851,0,32117
"Wabgai","Manipur",250,281,0,531,"1107 ","26489 ",99.00,"26596 ",100.00,12622,13974,0,26596
"Kakching","Manipur",190,177,0,367,"1055 ","25096 ",100.00,"25096 ",100.00,12215,12881,0,25096
"Hiyanglam","Manipur",240,247,0,487,"1020 ","23720 ",100.00,"23720 ",100.00,11741,11979,0,23720
"Sugnu","Manipur",373,351,0,724,"1012 ","24504 ",99.00,"24627 ",100.00,12243,12384,0,24627
"Jiribam","Manipur",436,376,0,812,"940 ","25435 ",99.00,"25619 ",100.00,13205,12414,0,25619
"Chandel (st)","Manipur",501,506,0,1007,"1071 ","41107 ",100.00,"41107 ",100.00,19847,21260,0,41107
"Tengnoupal (st)","Manipur",634,640,0,1274,"1012 ","42587 ",100.00,"42587 ",100.00,21170,21417,0,42587
"Phungyar (st)","Manipur",403,351,0,754,"988 ","25942 ",100.00,"25942 ",100.00,13051,12891,0,25942
"Ukhrul (st)","Manipur",488,547,0,1035,"1028 ","34058 ",99.00,"34306 ",100.00,16913,17393,0,34306
"Chingai (st)","Manipur",514,586,0,1100,"1042 ","35412 ",100.00,"35412 ",100.00,17344,18068,0,35412
"Saikul (st)","Manipur",394,373,0,767,"1045 ","33560 ",99.00,"33718 ",100.00,16490,17228,0,33718
"Karong (st)","Manipur",914,855,0,1769,"947 ","49485 ",98.00,"50050 ",100.00,25711,24339,0,50050
"Mao (st)","Manipur",1257,1155,0,2412,"1045 ","51216 ",98.00,"51785 ",100.00,25328,26457,0,51785
"Tadubi (st)","Manipur",551,467,0,1018,"953 ","42887 ",100.00,"42887 ",100.00,21965,20922,0,42887
"Kangpokpi (Gen)","Manipur",341,295,0,636,"972 ","27242 ",99.00,"27403 ",100.00,13893,13510,0,27403
"Saitu (ST)","Manipur",333,332,0,665,"1028 ","37192 ",99.00,"37404 ",100.00,18446,18958,0,37404
"Tamei (ST)","Manipur",361,446,0,807,"1036 ","31157 ",99.00,"31391 ",100.00,15417,15974,0,31391
"Tamenglong (ST)","Manipur",397,438,0,835,"1028 ","27488 ",100.00,"27488 ",100.00,13554,13934,0,27488
"Nungba (ST)","Manipur",433,488,0,921,"1050 ","22164 ",99.00,"22352 ",100.00,10906,11446,0,22352
"Tipaimukh (st)","Manipur",103,112,0,215,"966 ","16578 ",100.00,"16578 ",100.00,8431,8147,0,16578
"Thanlon (ST)","Manipur",62,76,0,138,"987 ","16958 ",100.00,"16958 ",100.00,8533,8425,0,16958
"Henglep (ST)","Manipur",145,145,0,290,"1037 ","26532 ",100.00,"26532 ",100.00,13023,13509,0,26532
"Churachandpur (ST)","Manipur",550,507,0,1057,"1110 ","47097 ",99.00,"47340 ",100.00,22437,24903,0,47340
"Saikot (ST)","Manipur",630,553,0,1183,"1064 ","44893 ",100.00,"44893 ",100.00,21750,23143,0,44893
"Singhat (ST)","Manipur",98,105,0,203,"1022 ","22909 ",100.00,"22909 ",100.00,11328,11581,0,22909
"Nartiang","Meghalaya",694,626,0,1320,"1036 ","31077 ",100.00,"31077 ",100.00,15266,15811,0,31077
"Jowai","Meghalaya",836,791,0,1627,"1136 ","29685 ",100.00,"29685 ",100.00,13900,15785,0,29685
"Raliang","Meghalaya",916,844,0,1760,"1088 ","27364 ",100.00,"27364 ",100.00,13107,14257,0,27364
"Mowkaiaw","Meghalaya",810,719,0,1529,"1009 ","26490 ",100.00,"26490 ",100.00,13187,13303,0,26490
"Sutnga Saipung","Meghalaya",808,707,0,1515,"992 ","32606 ",100.00,"32606 ",100.00,16365,16241,0,32606
"Khliehriat","Meghalaya",891,883,0,1774,"1067 ","32657 ",100.00,"32657 ",100.00,15797,16860,0,32657
"Amlarem","Meghalaya",566,507,0,1073,"1028 ","27872 ",100.00,"27872 ",100.00,13747,14125,0,27872
"Mawhati","Meghalaya",676,637,0,1313,"965 ","26267 ",100.00,"26267 ",100.00,13369,12898,0,26267
"Nongpoh","Meghalaya",563,534,0,1097,"1043 ","24746 ",100.00,"24746 ",100.00,12110,12636,0,24746
"Jirang","Meghalaya",612,512,0,1124,"933 ","29438 ",100.00,"29438 ",100.00,15232,14206,0,29438
"Umsning","Meghalaya",597,481,0,1078,"986 ","25536 ",100.00,"25536 ",100.00,12859,12677,0,25536
"Umroi","Meghalaya",475,477,0,952,"1004 ","20978 ",100.00,"20978 ",100.00,10470,10508,0,20978
"Mawryngkneng","Meghalaya",593,612,0,1205,"1077 ","26371 ",100.00,"26371 ",100.00,12696,13675,0,26371
"Pynthorumkhrah","Meghalaya",507,462,0,969,"1087 ","25996 ",100.00,"25996 ",100.00,12459,13537,0,25996
"Mawlai","Meghalaya",719,764,0,1483,"1200 ","35521 ",100.00,"35521 ",100.00,16149,19372,0,35521
"East Shillong","Meghalaya",294,253,0,547,"1123 ","22156 ",100.00,"22156 ",100.00,10437,11719,0,22156
"North Shillong","Meghalaya",530,532,0,1062,"1050 ","24770 ",100.00,"24770 ",100.00,12083,12687,0,24770
"West Shillong","Meghalaya",511,466,0,977,"1027 ","23709 ",100.00,"23709 ",100.00,11694,12015,0,23709
"South Shillong","Meghalaya",382,302,0,684,"998 ","28616 ",100.00,"28616 ",100.00,14321,14295,0,28616
"Mylliem","Meghalaya",833,856,0,1689,"1198 ","26486 ",100.00,"26486 ",100.00,12052,14434,0,26486
"Nongthymmai","Meghalaya",469,413,0,882,"1142 ","29421 ",100.00,"29421 ",100.00,13737,15684,0,29421
"Nongkrem","Meghalaya",498,491,0,989,"1127 ","27033 ",100.00,"27033 ",100.00,12708,14325,0,27033
"Sohiong","Meghalaya",648,588,0,1236,"1028 ","24347 ",100.00,"24347 ",100.00,12003,12344,0,24347
"Mawphlang","Meghalaya",508,546,0,1054,"1107 ","24809 ",100.00,"24809 ",100.00,11776,13033,0,24809
"Mawsynram","Meghalaya",482,425,0,907,"1003 ","26119 ",100.00,"26119 ",100.00,13039,13080,0,26119
"Shella","Meghalaya",524,447,0,971,"1009 ","21503 ",100.00,"21503 ",100.00,10706,10797,0,21503
"Pynursla","Meghalaya",611,551,0,1162,"1064 ","28935 ",100.00,"28935 ",100.00,14017,14918,0,28935
"Sohra","Meghalaya",589,651,0,1240,"1083 ","21199 ",100.00,"21199 ",100.00,10176,11023,0,21199
"Mawkynrew","Meghalaya",556,572,0,1128,"1028 ","26591 ",100.00,"26591 ",100.00,13114,13477,0,26591
"Mairang","Meghalaya",692,630,0,1322,"1025 ","29226 ",100.00,"29226 ",100.00,14430,14796,0,29226
"Mawthadraishan","Meghalaya",707,750,0,1457,"1035 ","29576 ",100.00,"29576 ",100.00,14533,15043,0,29576
"Nongstoin","Meghalaya",597,631,0,1228,"1034 ","27601 ",100.00,"27601 ",100.00,13571,14030,0,27601
"Rambrai Jyrngam","Meghalaya",450,468,0,918,"967 ","26175 ",100.00,"26175 ",100.00,13308,12867,0,26175
"Mawshynrut","Meghalaya",538,502,0,1040,"950 ","27090 ",100.00,"27090 ",100.00,13891,13199,0,27090
"Ranikor","Meghalaya",591,552,0,1143,"957 ","25355 ",100.00,"25355 ",100.00,12954,12401,0,25355
"Mawkyrwat","Meghalaya",587,529,0,1116,"1031 ","25637 ",100.00,"25637 ",100.00,12625,13012,0,25637
"Kharkutta","Meghalaya",640,523,0,1163,"954 ","30292 ",100.00,"30292 ",100.00,15499,14793,0,30292
"Mendipathar","Meghalaya",440,423,0,863,"976 ","21004 ",100.00,"21004 ",100.00,10629,10375,0,21004
"Resubelpara","Meghalaya",459,409,0,868,"980 ","21401 ",100.00,"21401 ",100.00,10810,10591,0,21401
"Bajengdoba","Meghalaya",624,544,0,1168,"945 ","23594 ",100.00,"23594 ",100.00,12128,11466,0,23594
"Songsak","Meghalaya",353,290,0,643,"924 ","22997 ",100.00,"22997 ",100.00,11953,11044,0,22997
"Rongjeng","Meghalaya",285,268,0,553,"947 ","24423 ",100.00,"24423 ",100.00,12545,11878,0,24423
"William Nagar","Meghalaya",296,282,0,578,"904 ","27496 ",100.00,"27496 ",100.00,14445,13051,0,27496
"Raksamgre","Meghalaya",467,440,0,907,"1026 ","22448 ",100.00,"22448 ",100.00,11078,11370,0,22448
"Tikrikila","Meghalaya",485,422,0,907,"1023 ","25823 ",100.00,"25823 ",100.00,12764,13059,0,25823
"Phulbari","Meghalaya",478,333,0,811,"969 ","23243 ",100.00,"23243 ",100.00,11802,11441,0,23243
"Rajabala","Meghalaya",649,520,0,1169,"1026 ","26764 ",100.00,"26764 ",100.00,13209,13555,0,26764
"Selsella","Meghalaya",503,400,0,903,"995 ","26694 ",100.00,"26694 ",100.00,13379,13315,0,26694
"Dadenggre","Meghalaya",455,453,0,908,"972 ","25559 ",100.00,"25559 ",100.00,12964,12595,0,25559
"North Tura","Meghalaya",399,413,0,812,"965 ","26555 ",100.00,"26555 ",100.00,13511,13044,0,26555
"South Tura","Meghalaya",398,364,0,762,"1013 ","26530 ",100.00,"26530 ",100.00,13180,13350,0,26530
"Rangsakona","Meghalaya",441,421,0,862,"1006 ","27353 ",100.00,"27353 ",100.00,13639,13714,0,27353
"Ampati","Meghalaya",443,389,0,832,"1021 ","24739 ",100.00,"24739 ",100.00,12241,12498,0,24739
"Mahendraganj","Meghalaya",605,548,0,1153,"1008 ","26555 ",100.00,"26555 ",100.00,13223,13332,0,26555
"Salmanpara","Meghalaya",525,422,0,947,"985 ","22131 ",100.00,"22131 ",100.00,11148,10983,0,22131
"Gambegre","Meghalaya",439,359,0,798,"962 ","22062 ",100.00,"22062 ",100.00,11245,10817,0,22062
"Dalu","Meghalaya",291,258,0,549,"988 ","16436 ",100.00,"16436 ",100.00,8267,8169,0,16436
"Rongara Siju","Meghalaya",443,419,0,862,"923 ","23397 ",100.00,"23397 ",100.00,12170,11227,0,23397
"Chokpot","Meghalaya",345,277,0,622,"927 ","22962 ",100.00,"22962 ",100.00,11913,11049,0,22962
"Baghmara","Meghalaya",441,366,0,807,"954 ","23612 ",100.00,"23612 ",100.00,12081,11531,0,23612
"Hachhek","Mizoram",531,542,0,1073,"971 ","21640 ",100.00,"21640 ",100.00,10982,10658,0,21640
"Dampa","Mizoram",291,263,0,554,"945 ","16442 ",100.00,"16442 ",100.00,8454,7988,0,16442
"Mamit","Mizoram",457,430,0,887,"974 ","20217 ",100.00,"20217 ",100.00,10244,9973,0,20217
"Tuirial","Mizoram",343,309,0,652,"998 ","15742 ",100.00,"15742 ",100.00,7877,7865,0,15742
"Kolasib","Mizoram",324,325,0,649,"1056 ","19191 ",100.00,"19191 ",100.00,9335,9856,0,19191
"Serlui","Mizoram",325,377,0,702,"1004 ","16868 ",100.00,"16868 ",100.00,8416,8452,0,16868
"Tuivawl","Mizoram",363,343,0,706,"1006 ","15141 ",100.00,"15141 ",100.00,7547,7594,0,15141
"Chalfilh","Mizoram",412,407,0,819,"962 ","17205 ",100.00,"17205 ",100.00,8768,8437,0,17205
"Tawi","Mizoram",317,310,0,627,"1073 ","14665 ",100.00,"14665 ",100.00,7075,7590,0,14665
"Aizawl  North - i","Mizoram",422,374,0,796,"1133 ","20471 ",100.00,"20471 ",100.00,9599,10872,0,20471
"Aizawl North - ii","Mizoram",388,353,0,741,"1127 ","20679 ",100.00,"20679 ",100.00,9720,10959,0,20679
"Aizawl North-iii","Mizoram",317,331,0,648,"1148 ","17188 ",100.00,"17188 ",100.00,8001,9187,0,17188
"Aizawl East - i","Mizoram",418,382,0,800,"1039 ","20467 ",100.00,"20467 ",100.00,10036,10431,0,20467
"Aizawl East ii","Mizoram",317,297,0,614,"1139 ","16341 ",100.00,"16341 ",100.00,7640,8701,0,16341
"Aizawl West i","Mizoram",442,402,0,844,"1069 ","21067 ",100.00,"21067 ",100.00,10182,10885,0,21067
"Aizawl West ii","Mizoram",340,388,0,728,"1115 ","18680 ",100.00,"18680 ",100.00,8832,9848,0,18680
"Aizawl West iii","Mizoram",369,372,0,741,"1116 ","19224 ",100.00,"19224 ",100.00,9087,10137,0,19224
"Aizawl South i","Mizoram",388,368,0,756,"1142 ","19994 ",100.00,"19994 ",100.00,9333,10661,0,19994
"Aizawl South ii","Mizoram",451,432,0,883,"1130 ","21342 ",100.00,"21342 ",100.00,10021,11321,0,21342
"Aizawl South-iii","Mizoram",458,407,0,865,"997 ","17963 ",100.00,"17963 ",100.00,8993,8970,0,17963
"Lengteng","Mizoram",387,362,0,749,"980 ","16328 ",100.00,"16328 ",100.00,8248,8080,0,16328
"Tuichang","Mizoram",360,360,0,720,"982 ","15052 ",100.00,"15052 ",100.00,7593,7459,0,15052
"Champhai North","Mizoram",443,418,0,861,"1021 ","17102 ",100.00,"17102 ",100.00,8462,8640,0,17102
"Champhai South","Mizoram",336,355,0,691,"1066 ","15795 ",100.00,"15795 ",100.00,7644,8151,0,15795
"East tuipui","Mizoram",426,383,0,809,"995 ","14070 ",100.00,"14070 ",100.00,7054,7016,0,14070
"Serchhip","Mizoram",754,840,0,1594,"1072 ","16083 ",100.00,"16083 ",100.00,7761,8322,0,16083
"Tuikum","Mizoram",855,804,0,1659,"1010 ","14520 ",100.00,"14520 ",100.00,7224,7296,0,14520
"Hrangturzo","Mizoram",678,664,0,1342,"1006 ","14804 ",100.00,"14804 ",100.00,7380,7424,0,14804
"South tuipui","Mizoram",684,759,0,1443,"1023 ","13779 ",100.00,"13779 ",100.00,6812,6967,0,13779
"Lunglei North","Mizoram",540,759,0,1299,"1018 ","14932 ",100.00,"14932 ",100.00,7398,7534,0,14932
"Lunglei East","Mizoram",412,404,0,816,"1055 ","13210 ",100.00,"13210 ",100.00,6427,6783,0,13210
"Lunglei West","Mizoram",517,473,0,990,"1069 ","13202 ",100.00,"13202 ",100.00,6380,6822,0,13202
"Lunglei South","Mizoram",546,584,0,1130,"1007 ","15260 ",100.00,"15260 ",100.00,7604,7656,0,15260
"Thorang","Mizoram",422,426,0,848,"940 ","12510 ",100.00,"12510 ",100.00,6447,6063,0,12510
"West tuipui","Mizoram",203,171,0,374,"890 ","12804 ",100.00,"12804 ",100.00,6775,6029,0,12804
"Tuichawng","Mizoram",616,543,0,1159,"989 ","26739 ",100.00,"26739 ",100.00,13445,13294,0,26739
"Lawngtlai West","Mizoram",675,624,0,1299,"1000 ","23697 ",100.00,"23697 ",100.00,11846,11851,0,23697
"Lawngtlai East","Mizoram",442,475,0,917,"1072 ","21640 ",100.00,"21640 ",100.00,10442,11198,0,21640
"Saiha","Mizoram",923,1023,0,1946,"1064 ","18645 ",100.00,"18645 ",100.00,9033,9612,0,18645
"Palak","Mizoram",833,811,0,1644,"1015 ","15749 ",100.00,"15749 ",100.00,7817,7932,0,15749
"Dimapur-i","Nagaland",210,150,0,360,"850 ","0 ",0.00,"18520 ",92.00,10841,9215,0,20056
"Dimapur-ii","Nagaland",452,388,0,840,"924 ","0 ",0.00,"42735 ",90.00,24470,22616,0,47086
"Dimapur-iii","Nagaland",409,433,0,842,"970 ","0 ",0.00,"27082 ",96.00,14221,13800,0,28021
"Ghaspani-i","Nagaland",491,453,0,944,"981 ","0 ",0.00,"55699 ",95.00,29594,29023,0,58617
"Ghaspani-ii","Nagaland",198,215,0,413,"984 ","0 ",0.00,"29322 ",97.00,15204,14959,0,30163
"Tenning","Nagaland",432,435,0,867,"971 ","0 ",0.00,"28639 ",99.00,14636,14209,0,28845
"Peren","Nagaland",404,420,0,824,"1029 ","0 ",0.00,"27083 ",99.00,13419,13805,0,27224
"Western angami","Nagaland",165,141,0,306,"1042 ","0 ",0.00,"15910 ",99.00,7803,8134,0,15937
"Kohima town","Nagaland",280,280,0,560,"973 ","0 ",0.00,"28749 ",99.00,14575,14184,0,28759
"Northern angami-i","Nagaland",149,162,0,311,"1088 ","0 ",0.00,"15295 ",99.00,7359,8004,0,15363
"Northern angami-ii","Nagaland",483,542,0,1025,"1022 ","0 ",0.00,"18642 ",99.00,9231,9435,0,18666
"Tseminyu","Nagaland",373,382,0,755,"1065 ","0 ",0.00,"24417 ",99.00,11829,12600,0,24429
"Pughoboto","Nagaland",204,251,0,455,"1020 ","0 ",0.00,"12484 ",98.00,6292,6415,0,12707
"Southern angami-i","Nagaland",188,158,0,346,"1109 ","0 ",0.00,"12942 ",99.00,6142,6813,0,12955
"Southern angami-ii","Nagaland",196,178,0,374,"1166 ","0 ",0.00,"16949 ",99.00,7828,9125,0,16953
"Pfutsero","Nagaland",322,406,0,728,"1071 ","0 ",0.00,"21300 ",99.00,10349,11087,0,21436
"Chizami","Nagaland",381,439,0,820,"1040 ","0 ",0.00,"16954 ",99.00,8367,8703,0,17070
"Chazouba","Nagaland",432,559,0,991,"1080 ","0 ",0.00,"24826 ",98.00,12071,13035,0,25106
"Phek","Nagaland",351,358,0,709,"981 ","0 ",0.00,"21686 ",99.00,11005,10792,0,21797
"Meluri","Nagaland",538,592,0,1130,"990 ","0 ",0.00,"19417 ",99.00,9769,9669,0,19438
"Tuli","Nagaland",280,265,0,545,"899 ","0 ",0.00,"17406 ",99.00,9169,8246,0,17415
"Arkakong","Nagaland",374,290,0,664,"971 ","0 ",0.00,"16442 ",99.00,8344,8099,0,16443
"Impur","Nagaland",309,315,0,624,"994 ","0 ",0.00,"9969 ",99.00,5000,4971,0,9971
"Angetyongpang","Nagaland",258,236,0,494,"945 ","0 ",0.00,"14479 ",99.00,7445,7036,0,14481
"Mongoya","Nagaland",331,314,0,645,"1039 ","0 ",0.00,"14494 ",99.00,7110,7390,0,14500
"Aonglenden","Nagaland",224,170,0,394,"1002 ","0 ",0.00,"11483 ",99.00,5741,5753,0,11494
"Mokokchung town","Nagaland",146,119,0,265,"1015 ","0 ",0.00,"5767 ",99.00,2864,2908,0,5772
"Koridang","Nagaland",313,288,0,601,"971 ","0 ",0.00,"18294 ",99.00,9282,9013,0,18295
"Jangpetkong","Nagaland",232,218,0,450,"972 ","0 ",0.00,"10655 ",99.00,5404,5254,0,10658
"Alongtaki","Nagaland",240,222,0,462,"989 ","0 ",0.00,"13766 ",99.00,6921,6848,0,13769
"Akuluto","Nagaland",163,150,0,313,"968 ","0 ",0.00,"10404 ",99.00,5290,5122,0,10412
"Atoizu","Nagaland",326,335,0,661,"1015 ","0 ",0.00,"15366 ",99.00,7628,7740,0,15368
"Suruhoto","Nagaland",269,272,0,541,"949 ","0 ",0.00,"13900 ",99.00,7136,6772,0,13908
"Aghunato","Nagaland",231,239,0,470,"1051 ","0 ",0.00,"14380 ",99.00,7014,7375,0,14389
"Zunheboto","Nagaland",648,658,0,1306,"1004 ","0 ",0.00,"19412 ",99.00,9748,9786,0,19534
"Satakha","Nagaland",444,461,0,905,"1007 ","0 ",0.00,"15041 ",99.00,7499,7553,0,15052
"Tyui","Nagaland",506,535,0,1041,"1039 ","0 ",0.00,"20843 ",99.00,10253,10653,0,20906
"Wokha","Nagaland",786,861,0,1647,"1016 ","0 ",0.00,"31992 ",98.00,16124,16382,0,32506
"Sanis","Nagaland",422,417,0,839,"1005 ","0 ",0.00,"21667 ",99.00,10847,10903,0,21750
"Bhandari","Nagaland",506,476,0,982,"942 ","0 ",0.00,"24878 ",99.00,12863,12111,0,24974
"Tizit","Nagaland",168,154,0,322,"877 ","0 ",0.00,"18250 ",99.00,9722,8530,0,18252
"Wakching","Nagaland",158,180,0,338,"917 ","0 ",0.00,"17884 ",99.00,9328,8558,0,17886
"Tapi","Nagaland",155,193,0,348,"931 ","0 ",0.00,"14598 ",99.00,7560,7040,0,14600
"Phomching","Nagaland",96,85,0,181,"883 ","0 ",0.00,"19096 ",100.00,10139,8957,0,19096
"Tehok","Nagaland",136,184,0,320,"902 ","0 ",0.00,"15306 ",100.00,8047,7259,0,15306
"Mon town","Nagaland",254,265,0,519,"929 ","0 ",0.00,"18883 ",99.00,9792,9099,0,18891
"Aboi","Nagaland",201,195,0,396,"913 ","0 ",0.00,"11221 ",99.00,5868,5355,0,11223
"Moka","Nagaland",410,381,0,791,"947 ","0 ",0.00,"17119 ",99.00,8794,8329,0,17123
"Tamlu","Nagaland",149,158,0,307,"891 ","0 ",0.00,"14386 ",99.00,7622,6789,0,14411
"Longleng","Nagaland",373,410,0,783,"911 ","0 ",0.00,"22718 ",99.00,11938,10872,0,22810
"Noksen","Nagaland",54,49,0,103,"939 ","0 ",0.00,"12005 ",100.00,6192,5813,0,12005
"Longkhim chare","Nagaland",230,227,0,457,"955 ","0 ",0.00,"20192 ",100.00,10331,9862,0,20193
"Tuensang sadar-i","Nagaland",321,272,0,593,"867 ","0 ",0.00,"21635 ",99.00,11592,10045,0,21637
"Tuensang sadar-ii","Nagaland",160,183,0,343,"981 ","0 ",0.00,"18831 ",99.00,9507,9326,0,18833
"Tobu","Nagaland",144,181,0,325,"947 ","0 ",0.00,"18260 ",99.00,9383,8882,0,18265
"Noklak","Nagaland",209,198,0,407,"923 ","0 ",0.00,"15186 ",99.00,7897,7290,0,15187
"Thonoknyu","Nagaland",185,206,0,391,"926 ","0 ",0.00,"18276 ",99.00,9488,8789,0,18277
"Shamator chessore","Nagaland",221,237,0,458,"1012 ","0 ",0.00,"17144 ",100.00,8521,8623,0,17144
"Seyochung sitimi","Nagaland",280,314,0,594,"1008 ","0 ",0.00,"21834 ",99.00,10921,11003,0,21924
"Pungro kiphire","Nagaland",364,370,0,734,"927 ","0 ",0.00,"29290 ",99.00,15243,14132,0,29375
"NERELA","NCT OF Delhi",2403,1229,0,3632,"794 ","213507 ",100.00,"213507 ",100.00,118972,94520,15,213507
"BURARI","NCT OF Delhi",3249,2041,1,5291,"765 ","247715 ",100.00,"247715 ",100.00,140340,107366,9,247715
"TIMARPUR","NCT OF Delhi",1981,1434,0,3415,"832 ","174728 ",100.00,"174728 ",100.00,95372,79341,15,174728
"ADARSH NAGAR","NCT OF Delhi",1497,1115,0,2612,"800 ","147478 ",100.00,"147478 ",100.00,81919,65551,8,147478
"BADLI","NCT OF Delhi",2482,1496,0,3978,"744 ","200994 ",100.00,"200994 ",100.00,115215,85772,7,200994
"RITHALA","NCT OF Delhi",2602,1723,0,4325,"860 ","225039 ",100.00,"225039 ",100.00,120976,104045,18,225039
"BAWANA","NCT OF Delhi",3510,2180,1,5691,"790 ","276393 ",100.00,"276393 ",100.00,154368,122007,18,276393
"MUNDKA","NCT OF Delhi",3246,1939,2,5187,"841 ","245233 ",100.00,"245233 ",100.00,133211,112001,21,245233
"KIRARI","NCT OF Delhi",3135,1856,1,4992,"736 ","220547 ",100.00,"220547 ",100.00,127063,93468,16,220547
"SULTANPUR MAJRA","NCT OF Delhi",2294,1521,0,3815,"837 ","161067 ",100.00,"161067 ",100.00,87644,73391,32,161067
"NANGLOI JAT","NCT OF Delhi",2644,1465,3,4112,"780 ","220326 ",100.00,"220326 ",100.00,123791,96527,8,220326
"MANGOL PURI","NCT OF Delhi",2108,1386,0,3494,"859 ","165605 ",100.00,"165605 ",100.00,89091,76505,9,165605
"ROHINI","NCT OF Delhi",1818,1186,0,3004,"913 ","165211 ",100.00,"165211 ",100.00,86366,78837,8,165211
"SHALIMAR BAGH","NCT OF Delhi",1619,1009,0,2628,"852 ","162674 ",100.00,"162674 ",100.00,87813,74851,10,162674
"SHAKUR BASTI","NCT OF Delhi",1303,871,0,2174,"934 ","136068 ",100.00,"136068 ",100.00,70350,65717,1,136068
"TRI NAGAR","NCT OF Delhi",1760,1082,0,2842,"816 ","148841 ",100.00,"148841 ",100.00,81981,66857,3,148841
"WAZIRPUR","NCT OF Delhi",1381,967,0,2348,"788 ","151142 ",100.00,"151142 ",100.00,84550,66590,2,151142
"MODEL TOWN","NCT OF Delhi",1428,871,0,2299,"810 ","142786 ",100.00,"142786 ",100.00,78900,63885,1,142786
"SADAR BAZAR","NCT OF Delhi",1647,1252,0,2899,"830 ","153975 ",100.00,"153975 ",100.00,84150,69820,5,153975
"CHANDNI CHOWK","NCT OF Delhi",843,647,0,1490,"815 ","107208 ",100.00,"107208 ",100.00,59067,48137,4,107208
"MATIA MAHAL","NCT OF Delhi",762,702,0,1464,"875 ","109764 ",100.00,"109764 ",100.00,58551,51205,8,109764
"BALLIMARAN","NCT OF Delhi",1165,763,1,1929,"788 ","132459 ",100.00,"132459 ",100.00,74083,58367,9,132459
"KAROL BAGH","NCT OF Delhi",1474,1019,1,2494,"825 ","152965 ",100.00,"152965 ",100.00,83798,69162,5,152965
"PATEL NAGAR","NCT OF Delhi",1398,1103,1,2502,"840 ","156344 ",100.00,"156344 ",100.00,84951,71390,3,156344
"MOTI NAGAR","NCT OF Delhi",1854,1054,1,2909,"776 ","149686 ",100.00,"149686 ",100.00,84293,65386,7,149686
"MADIPUR","NCT OF Delhi",1349,1113,1,2463,"884 ","149477 ",100.00,"149477 ",100.00,79338,70136,3,149477
"RAJOURI GARDEN","NCT OF Delhi",1378,1002,1,2381,"897 ","147323 ",100.00,"147323 ",100.00,77649,69669,5,147323
"HARI NAGAR","NCT OF Delhi",1378,938,0,2316,"864 ","151358 ",100.00,"151358 ",100.00,81211,70143,4,151358
"TILAK NAGAR","NCT OF Delhi",1142,820,0,1962,"936 ","134299 ",100.00,"134299 ",100.00,69369,64923,7,134299
"JANAKPURI","NCT OF Delhi",1555,1232,1,2788,"876 ","158096 ",100.00,"158096 ",100.00,84266,73827,3,158096
"VIKASPURI","NCT OF Delhi",3880,2358,1,6239,"772 ","289593 ",100.00,"289593 ",100.00,163437,126133,23,289593
"UTTAM NAGAR","NCT OF Delhi",2440,1656,1,4097,"833 ","195299 ",100.00,"195299 ",100.00,106559,88732,8,195299
"DWARKA","NCT OF Delhi",2388,1422,0,3810,"766 ","177494 ",100.00,"177494 ",100.00,100480,77010,4,177494
"MATIALA","NCT OF Delhi",4057,2549,3,6609,"826 ","305259 ",100.00,"305259 ",100.00,167182,138051,26,305259
"NAJAFGARH","NCT OF Delhi",2889,1694,0,4583,"862 ","214141 ",100.00,"214141 ",100.00,114989,99147,5,214141
"BIJWASAN","NCT OF Delhi",2225,1373,1,3599,"777 ","167492 ",100.00,"167492 ",100.00,94245,73234,13,167492
"PALAM","NCT OF Delhi",2538,1660,2,4200,"817 ","205886 ",100.00,"205886 ",100.00,113313,92562,11,205886
"DELHI CANTT","NCT OF Delhi",1800,1078,0,2878,"695 ","111668 ",100.00,"111668 ",100.00,65891,45769,8,111668
"RAJINDER NAGAR","NCT OF Delhi",1671,1044,0,2715,"756 ","166401 ",100.00,"166401 ",100.00,94774,71622,5,166401
"NEW DELHI","NCT OF Delhi",1554,1111,0,2665,"812 ","125949 ",100.00,"125949 ",100.00,69514,56432,3,125949
"JANGPURA","NCT OF Delhi",1249,787,1,2037,"814 ","131047 ",100.00,"131047 ",100.00,72240,58800,7,131047
"KASTURBA NAGAR","NCT OF Delhi",1372,853,0,2225,"779 ","137304 ",100.00,"137304 ",100.00,77172,60132,0,137304
"MALVIYA NAGAR","NCT OF Delhi",1426,952,1,2379,"832 ","126951 ",100.00,"126951 ",100.00,69299,57645,7,126951
"R K PURAM","NCT OF Delhi",1522,1092,1,2615,"782 ","134422 ",100.00,"134422 ",100.00,75415,59004,3,134422
"MEHRAULI","NCT OF Delhi",1735,1064,0,2799,"770 ","158706 ",100.00,"158706 ",100.00,89638,69059,9,158706
"CHHATARPUR","NCT OF Delhi",2014,1082,0,3096,"702 ","168665 ",100.00,"168665 ",100.00,99084,69578,3,168665
"DEOLI","NCT OF Delhi",2007,1187,0,3194,"748 ","185870 ",100.00,"185870 ",100.00,106327,79537,6,185870
"AMBEDKAR NAGAR","NCT OF Delhi",1379,888,2,2269,"832 ","125995 ",100.00,"125995 ",100.00,68755,57234,6,125995
"SANGAM VIHAR","NCT OF Delhi",1677,888,0,2565,"681 ","139951 ",100.00,"139951 ",100.00,83268,56674,9,139951
"GREATER KAILASH","NCT OF Delhi",1176,902,0,2078,"859 ","146541 ",100.00,"146541 ",100.00,78827,67707,7,146541
"KALKAJI","NCT OF Delhi",1415,1000,1,2416,"794 ","146482 ",100.00,"146482 ",100.00,81637,64836,9,146482
"TUGHLAKABAD","NCT OF Delhi",1549,871,3,2423,"644 ","133680 ",100.00,"133680 ",100.00,81306,52364,10,133680
"BADARPUR","NCT OF Delhi",2742,1428,1,4171,"705 ","210148 ",100.00,"210148 ",100.00,123228,86904,16,210148
"OKHLA","NCT OF Delhi",2904,1517,0,4421,"656 ","238236 ",100.00,"238236 ",100.00,143863,94353,20,238236
"TRILOKPURI","NCT OF Delhi",2008,1469,0,3477,"807 ","164953 ",100.00,"164953 ",100.00,91281,73656,16,164953
"KONDLI","NCT OF Delhi",2023,1396,0,3419,"806 ","160695 ",100.00,"160695 ",100.00,88989,71694,12,160695
"PATPARGANJ","NCT OF Delhi",2143,1332,0,3475,"773 ","192450 ",100.00,"192450 ",100.00,108512,83930,8,192450
"LAXMI NAGAR","NCT OF Delhi",1924,1209,0,3133,"777 ","185392 ",100.00,"185392 ",100.00,104327,81051,14,185392
"VISHWAS NAGAR","NCT OF Delhi",1988,1202,1,3191,"833 ","173138 ",100.00,"173138 ",100.00,94459,78660,19,173138
"KRISHNA NAGAR","NCT OF Delhi",1589,1063,0,2652,"887 ","176254 ",100.00,"176254 ",100.00,93397,82856,1,176254
"GANDHI NAGAR","NCT OF Delhi",1599,904,0,2503,"771 ","153326 ",100.00,"153326 ",100.00,86579,66735,12,153326
"SHAHDARA","NCT OF Delhi",1741,1198,0,2939,"874 ","158240 ",100.00,"158240 ",100.00,84455,73779,6,158240
"SEEMA PURI","NCT OF Delhi",1955,1456,0,3411,"870 ","159588 ",100.00,"159588 ",100.00,85333,74243,12,159588
"ROHTAS NAGAR","NCT OF Delhi",1904,1284,1,3189,"877 ","177080 ",100.00,"177080 ",100.00,94357,82714,9,177080
"SEELAMPUR","NCT OF Delhi",1391,987,0,2378,"818 ","144453 ",100.00,"144453 ",100.00,79476,64977,0,144453
"GHONDA","NCT OF Delhi",1731,1128,0,2859,"818 ","184655 ",100.00,"184655 ",100.00,101575,83074,6,184655
"BABARPUR","NCT OF Delhi",1792,1177,2,2971,"830 ","175609 ",100.00,"175609 ",100.00,95953,79633,23,175609
"GOKALPUR","NCT OF Delhi",2465,1444,1,3910,"808 ","181001 ",100.00,"181001 ",100.00,100082,80913,6,181001
"MUSTAFABAD","NCT OF Delhi",3130,1752,0,4882,"809 ","209754 ",100.00,"209754 ",100.00,115975,93773,6,209754
"KARAWAL NAGAR","NCT OF Delhi",3087,1838,0,4925,"761 ","212417 ",100.00,"212417 ",100.00,120635,91776,6,212417
"Padampur","Orissa",4123,1929,0,6052,"946 ","221565 ",99.00,"220556 ",98.00,114930,108719,0,223649
"Bijepur","Orissa",3494,1352,0,4846,"900 ","203410 ",98.00,"202744 ",98.00,108653,97783,0,206436
"Bargarh","Orissa",2628,1369,0,3997,"883 ","188491 ",94.00,"185653 ",93.00,105460,93093,1,198554
"Attabira","Orissa",2526,1248,0,3774,"879 ","197930 ",97.00,"196269 ",97.00,107625,94650,2,202277
"Bhatli","Orissa",3615,1320,0,4935,"895 ","202690 ",98.00,"201201 ",97.00,108985,97572,0,206557
"Brajarajnagar","Orissa",3068,1662,7,4737,"883 ","188582 ",99.00,"188010 ",99.00,100337,88637,38,189012
"Jharsuguda","Orissa",3336,2229,7,5572,"939 ","196084 ",99.00,"194927 ",98.00,101645,95455,47,197147
"Talsara","Orissa",2994,2324,0,5318,"1004 ","185815 ",96.00,"182215 ",94.00,96087,96456,2,192545
"Sundargarh","Orissa",3371,2473,0,5844,"966 ","208183 ",96.00,"204163 ",94.00,109921,106230,1,216152
"Biramitrapur","Orissa",4020,3118,0,7138,"989 ","208092 ",99.00,"205612 ",97.00,105604,104470,3,210077
"Raghunathpali","Orissa",2504,2089,0,4593,"905 ","158277 ",98.00,"157048 ",98.00,84055,76082,1,160138
"Rourkela","Orissa",2603,1981,1,4585,"871 ","175817 ",98.00,"170832 ",95.00,95732,83404,4,179140
"Rajgangapur","Orissa",3894,3256,0,7150,"970 ","212848 ",94.00,"208414 ",92.00,114424,110995,1,225420
"Bonai","Orissa",3952,3217,4,7173,"994 ","197681 ",99.00,"197293 ",99.00,99845,99223,12,199080
"Kuchinda","Orissa",3435,2419,0,5854,"979 ","193175 ",100.00,"193175 ",100.00,97612,95555,8,193175
"Rengali","Orissa",2316,1406,0,3722,"946 ","168904 ",100.00,"168903 ",100.00,86789,82109,12,168910
"Sambalpur","Orissa",1854,1353,1,3208,"911 ","172909 ",100.00,"172909 ",100.00,90471,82426,19,172916
"Rairakhol","Orissa",3008,1599,2,4609,"938 ","174514 ",99.00,"174513 ",99.00,90024,84486,16,174526
"Deogarh","Orissa",3185,2190,0,5375,"949 ","208239 ",98.00,"206410 ",97.00,108127,102582,3,210712
"Telkoi","Orissa",4245,3138,6,7389,"970 ","194674 ",98.00,"192040 ",96.00,100573,97549,13,198135
"Ghasipura","Orissa",3516,2124,0,5640,"934 ","194512 ",98.00,"193296 ",98.00,101646,94957,2,196605
"Anandapur","Orissa",3421,2108,0,5529,"929 ","197087 ",99.00,"196597 ",99.00,102837,95491,1,198329
"Patna","Orissa",2558,1720,3,4281,"956 ","182270 ",100.00,"179322 ",98.00,93158,89102,3,182263
"Keonjhar","Orissa",3528,2518,0,6046,"951 ","193633 ",96.00,"191916 ",96.00,102345,97319,9,199673
"Champua","Orissa",3645,2877,1,6523,"912 ","187981 ",96.00,"185259 ",95.00,101910,92983,4,194897
"Jashipur","Orissa",3816,2823,2,6641,"984 ","188387 ",99.00,"187622 ",98.00,95874,94304,4,190182
"Saraskana","Orissa",3354,2485,1,5840,"996 ","181029 ",99.00,"180131 ",98.00,91337,90982,6,182325
"Rairangpur","Orissa",3707,2724,1,6432,"1008 ","204349 ",97.00,"202911 ",97.00,103851,104728,3,208582
"Bangriposi","Orissa",3000,2048,0,5048,"961 ","181451 ",99.00,"181222 ",99.00,92521,88957,1,181479
"Karanjia","Orissa",2905,2230,0,5135,"979 ","163066 ",98.00,"161430 ",97.00,83269,81496,3,164768
"Udala","Orissa",3024,2122,0,5146,"976 ","169198 ",99.00,"168774 ",99.00,86157,84112,0,170269
"Badasahi","Orissa",2677,1857,1,4535,"961 ","166833 ",99.00,"166321 ",98.00,85755,82408,4,168167
"Baripada","Orissa",2985,2383,0,5368,"978 ","187064 ",98.00,"185459 ",97.00,95808,93663,0,189471
"Morada","Orissa",3753,2501,0,6254,"963 ","196543 ",99.00,"195505 ",98.00,100605,96893,2,197500
"Jaleswar","Orissa",3283,1861,0,5144,"933 ","207125 ",98.00,"205287 ",97.00,109198,101857,2,211057
"Bhograi","Orissa",3860,2600,1,6461,"915 ","197310 ",97.00,"195908 ",96.00,105627,96598,3,202228
"Basta","Orissa",3796,2524,0,6320,"923 ","196425 ",97.00,"194699 ",96.00,104422,96371,0,200793
"Balasore","Orissa",2738,1649,3,4390,"903 ","183175 ",93.00,"178363 ",91.00,102900,92942,4,195846
"Remuna","Orissa",2633,1606,1,4240,"907 ","184339 ",95.00,"181845 ",93.00,101511,92035,4,193550
"Nilgiri","Orissa",2556,1586,0,4142,"948 ","175356 ",98.00,"174307 ",97.00,91476,86716,1,178193
"Soro","Orissa",3346,2015,2,5363,"915 ","186674 ",97.00,"184440 ",95.00,100489,91961,2,192452
"Simulia","Orissa",3353,1865,0,5218,"936 ","205916 ",97.00,"203305 ",96.00,109073,102055,8,211136
"Bhandaripokhari","Orissa",3920,2387,2,6309,"912 ","198581 ",98.00,"197888 ",98.00,104916,95685,5,200606
"Bhadrak","Orissa",3859,2437,0,6296,"899 ","215711 ",95.00,"212600 ",94.00,119076,106992,9,226077
"Basudevpur","Orissa",3942,2211,0,6153,"882 ","213873 ",98.00,"212705 ",97.00,115879,102168,1,218048
"Dhamnagar","Orissa",4101,2320,0,6421,"868 ","198752 ",98.00,"198081 ",98.00,107558,93308,1,200867
"Chandabali","Orissa",3891,1879,0,5770,"867 ","198666 ",97.00,"197498 ",97.00,108724,94225,4,202953
"Binjharpur","Orissa",3192,1475,0,4667,"847 ","185509 ",97.00,"183662 ",96.00,102793,87108,0,189901
"Bari","Orissa",3069,1433,1,4503,"836 ","187758 ",99.00,"187245 ",98.00,103074,86195,2,189271
"Barchana","Orissa",2555,1364,0,3919,"908 ","163265 ",99.00,"163166 ",99.00,85755,77846,2,163603
"Dharmasala","Orissa",3180,1575,0,4755,"873 ","191467 ",98.00,"190827 ",98.00,103393,90213,2,193608
"Jajpur","Orissa",3368,1765,0,5133,"856 ","201678 ",97.00,"198738 ",95.00,111649,95540,3,207192
"Korei","Orissa",3012,1524,0,4536,"875 ","169217 ",97.00,"167593 ",96.00,92785,81149,0,173934
"Sukinda","Orissa",3013,1903,0,4916,"906 ","169892 ",98.00,"168395 ",97.00,90353,81853,2,172208
"Dhenkanal","Orissa",3324,1757,0,5081,"904 ","228457 ",99.00,"228446 ",99.00,120033,108452,13,228498
"Hindol","Orissa",3949,1823,3,5775,"883 ","226627 ",99.00,"226404 ",99.00,121137,107011,11,228159
"Kamakhyanagar","Orissa",3312,1730,2,5044,"879 ","191205 ",99.00,"191072 ",99.00,102089,89725,3,191817
"Parjanga","Orissa",3162,1562,1,4725,"904 ","187046 ",99.00,"186198 ",98.00,99148,89607,4,188759
"Pallahara","Orissa",3361,1609,1,4971,"909 ","152633 ",100.00,"152633 ",100.00,79958,72675,1,152634
"Talcher","Orissa",2657,1359,0,4016,"847 ","157873 ",99.00,"157859 ",99.00,85521,72440,2,157963
"Angul","Orissa",3372,1533,1,4906,"880 ","194238 ",99.00,"193776 ",98.00,104324,91831,2,196157
"Chhendipada","Orissa",2932,1387,0,4319,"908 ","184256 ",99.00,"183832 ",98.00,97423,88507,1,185931
"Athamallik","Orissa",3424,2201,0,5625,"931 ","176891 ",100.00,"176890 ",100.00,91602,85288,1,176891
"Birmaharajpur","Orissa",3669,1767,0,5436,"875 ","183380 ",99.00,"182043 ",98.00,98622,86301,0,184923
"Sonepur","Orissa",3591,1766,2,5359,"897 ","225249 ",97.00,"223221 ",96.00,122109,109490,15,231614
"Loisingha","Orissa",3116,1170,0,4286,"901 ","203984 ",97.00,"202521 ",96.00,110376,99418,10,209804
"Patnagarh","Orissa",3453,1311,3,4767,"931 ","247191 ",98.00,"246162 ",98.00,130004,121075,10,251089
"Bolangir","Orissa",3016,1447,0,4463,"918 ","194305 ",92.00,"190775 ",90.00,109872,100858,6,210736
"Titlagarh","Orissa",3122,1472,0,4594,"938 ","216075 ",95.00,"213804 ",94.00,116447,109248,18,225713
"Kantabanji","Orissa",3501,1764,0,5265,"954 ","230107 ",95.00,"228088 ",94.00,123517,117798,22,241337
"Nuapada","Orissa",4058,2373,4,6435,"977 ","202421 ",98.00,"201317 ",97.00,104067,101680,14,205761
"Khariar","Orissa",3507,1843,0,5350,"959 ","211174 ",97.00,"206418 ",94.00,111146,106533,3,217682
"Umarkote","Orissa",4180,2925,2,7107,"959 ","168819 ",97.00,"167687 ",97.00,88225,84573,2,172800
"Jharigam","Orissa",4929,3955,2,8886,"998 ","189365 ",98.00,"188226 ",97.00,96220,95980,5,192205
"Nabarangpur","Orissa",4551,3798,12,8361,"1028 ","206874 ",98.00,"205042 ",98.00,103128,106064,21,209213
"Dabugam","Orissa",3289,3247,0,6536,"1033 ","174791 ",98.00,"173479 ",98.00,86894,89763,9,176666
"Lanjigarh","Orissa",4126,2299,0,6425,"1009 ","185545 ",96.00,"183337 ",94.00,96176,97050,12,193238
"Junagarh","Orissa",4256,1763,2,6021,"950 ","210959 ",97.00,"206106 ",95.00,110608,105090,17,215715
"Dharmgarh","Orissa",5004,2199,3,7206,"961 ","226045 ",97.00,"222309 ",95.00,118543,113963,7,232513
"Bhawanipatna","Orissa",3182,1517,0,4699,"941 ","195416 ",95.00,"192253 ",93.00,105507,99250,7,204764
"Narla","Orissa",3782,1828,0,5610,"951 ","194638 ",99.00,"193876 ",98.00,100492,95564,3,196059
"Baliguda","Orissa",2454,1941,0,4395,"1043 ","134543 ",98.00,"134085 ",97.00,67151,70008,4,137163
"G. Udayagiri","Orissa",2884,2093,3,4980,"1028 ","168957 ",97.00,"168036 ",97.00,85303,87718,26,173047
"Phulbani","Orissa",2420,1932,0,4352,"1009 ","164294 ",99.00,"164133 ",99.00,82215,82932,0,165147
"Kantamal","Orissa",2599,1392,0,3991,"968 ","142212 ",99.00,"141966 ",99.00,72674,70352,0,143026
"Boudh","Orissa",2528,1362,0,3890,"941 ","138659 ",99.00,"138404 ",99.00,71875,67643,0,139518
"Baramba","Orissa",3317,1555,0,4872,"866 ","210282 ",97.00,"209459 ",97.00,115254,99800,2,215056
"Banki","Orissa",3132,1377,1,4510,"861 ","188008 ",99.00,"187924 ",99.00,101307,87178,4,188489
"Athagarh","Orissa",2881,1381,0,4262,"888 ","181121 ",97.00,"179967 ",96.00,98399,87423,0,185822
"Barabati-Cuttack","Orissa",1674,1308,0,2982,"897 ","189712 ",94.00,"184738 ",92.00,105436,94525,4,199965
"Choudwar-Cuttack","Orissa",2093,1306,1,3400,"867 ","196640 ",95.00,"192187 ",93.00,110196,95566,5,205767
"Niali","Orissa",2537,1303,7,3847,"877 ","210224 ",96.00,"208304 ",95.00,116115,101851,14,217980
"Cuttack Sadar","Orissa",2347,1293,1,3641,"869 ","188230 ",95.00,"182643 ",92.00,105246,91472,2,196720
"Salipur","Orissa",2667,1374,1,4042,"885 ","206893 ",98.00,"205443 ",97.00,111448,98596,2,210046
"Mahanga","Orissa",3559,1782,2,5343,"863 ","228956 ",97.00,"226820 ",96.00,125583,108359,8,233950
"Patkura","Orissa",3428,1799,0,5227,"877 ","218997 ",97.00,"217183 ",96.00,119515,104860,1,224376
"Kendrapara","Orissa",3050,1563,0,4613,"870 ","190625 ",98.00,"189501 ",97.00,103600,90160,4,193764
"Aul","Orissa",4172,2403,1,6576,"869 ","233091 ",97.00,"231607 ",97.00,127351,110617,1,237969
"Rajanagar","Orissa",4124,1765,0,5889,"877 ","212939 ",98.00,"211406 ",97.00,115224,101015,0,216239
"Mahakalapada","Orissa",3345,1555,1,4901,"870 ","210478 ",97.00,"209507 ",97.00,114922,100019,1,214942
"Paradeep","Orissa",2707,1439,0,4146,"841 ","185942 ",98.00,"184966 ",98.00,102104,85871,16,187991
"Tirtol","Orissa",2940,1532,0,4472,"878 ","211723 ",99.00,"210580 ",98.00,113659,99814,10,213483
"Balikuda-Ersama","Orissa",3476,1721,0,5197,"870 ","230386 ",99.00,"229691 ",99.00,123636,107602,11,231249
"Jagatsinghpur","Orissa",3168,1744,1,4913,"876 ","192538 ",99.00,"191799 ",98.00,103388,90524,15,193927
"Kakatpur","Orissa",3337,1652,0,4989,"895 ","208948 ",94.00,"206937 ",93.00,116365,104157,0,220522
"Nimapara","Orissa",3089,1797,0,4886,"897 ","210922 ",96.00,"209273 ",95.00,115729,103857,0,219586
"Puri","Orissa",2184,1311,0,3495,"899 ","199662 ",89.00,"196642 ",88.00,116832,105059,1,221892
"Bramhagiri","Orissa",3221,2093,0,5314,"925 ","183920 ",94.00,"181756 ",93.00,100786,93236,2,194024
"Satyabadi","Orissa",2858,1709,0,4567,"905 ","179722 ",94.00,"177478 ",93.00,99593,90130,4,189727
"Pipili","Orissa",2905,1594,0,4499,"906 ","194942 ",94.00,"193750 ",93.00,108695,98450,17,207162
"Jayadev","Orissa",1885,860,1,2746,"881 ","157616 ",95.00,"156891 ",94.00,88004,77507,4,165515
"Bhubaneswar Central (Madhya)","Orissa",1917,1373,5,3295,"721 ","171150 ",80.00,"169529 ",79.00,123222,88902,89,212213
"Bhubaneswar North (Uttar)","Orissa",2259,1441,0,3700,"751 ","207123 ",79.00,"205607 ",78.00,149026,111963,32,261021
"Ekamra-Bhubaneswar","Orissa",2145,1515,6,3666,"798 ","186670 ",78.00,"184515 ",77.00,132802,106039,108,238949
"Jatani","Orissa",2642,1331,0,3973,"891 ","189766 ",92.00,"187839 ",92.00,107970,96192,4,204166
"Begunia","Orissa",2982,1701,1,4684,"888 ","192060 ",99.00,"191798 ",98.00,102695,91220,5,193920
"Khurda","Orissa",3257,1771,1,5029,"897 ","207305 ",97.00,"205431 ",96.00,112672,101014,5,213691
"Chilika","Orissa",4019,1812,1,5832,"863 ","195792 ",97.00,"195106 ",97.00,107518,92816,7,200341
"Ranpur","Orissa",2617,1210,0,3827,"871 ","179921 ",97.00,"179060 ",96.00,98879,86132,5,185016
"Khandapada","Orissa",2625,1212,0,3837,"860 ","158253 ",97.00,"157669 ",96.00,87519,75226,2,162747
"Daspalla","Orissa",2486,1325,0,3811,"892 ","164284 ",97.00,"163787 ",97.00,89191,79518,0,168709
"Nayagarh","Orissa",2701,1327,0,4028,"855 ","183354 ",94.00,"182336 ",94.00,104035,88995,1,193031
"Bhanjanagar","Orissa",3617,1787,0,5404,"906 ","207483 ",98.00,"206820 ",98.00,110185,99789,5,209979
"Polasara","Orissa",3867,2009,0,5876,"881 ","207713 ",97.00,"206789 ",96.00,113553,100094,0,213647
"Kabisuryangar","Orissa",3845,1592,0,5437,"879 ","198897 ",97.00,"197449 ",96.00,108996,95758,10,204764
"Khalikote","Orissa",3925,1699,1,5625,"882 ","191053 ",97.00,"188847 ",95.00,104682,92289,1,196972
"Chhatrapur","Orissa",3888,1915,1,5804,"924 ","198106 ",97.00,"196857 ",96.00,105996,97968,2,203966
"Aska","Orissa",3093,1468,1,4562,"865 ","174774 ",97.00,"172620 ",96.00,96358,83385,4,179747
"Surada","Orissa",3868,1853,1,5722,"874 ","203310 ",98.00,"202353 ",98.00,109777,95960,6,205743
"Sanakhemundi","Orissa",3831,1938,0,5769,"881 ","190728 ",97.00,"188739 ",96.00,104352,91894,2,196248
"Hinjili","Orissa",3558,1689,1,5248,"867 ","193985 ",96.00,"191613 ",95.00,107370,93097,2,200469
"Gopalpur","Orissa",3137,1726,0,4863,"946 ","171810 ",98.00,"171127 ",97.00,89879,85026,0,174905
"Berhampur","Orissa",3011,2347,1,5359,"965 ","175250 ",98.00,"174441 ",97.00,90809,87595,1,178405
"Digapahandi","Orissa",3500,1850,0,5350,"901 ","181726 ",97.00,"180056 ",96.00,98433,88699,2,187134
"Chikiti","Orissa",3724,2078,1,5803,"958 ","182440 ",97.00,"179896 ",96.00,95332,91308,3,186643
"Mohana","Orissa",4312,3146,0,7458,"1025 ","191027 ",99.00,"190137 ",98.00,95104,97509,0,192613
"Paralakhemundi","Orissa",3423,2636,0,6059,"1023 ","190109 ",98.00,"189308 ",98.00,95315,97467,0,192782
"Gunupur","Orissa",4522,3756,2,8280,"1056 ","188660 ",97.00,"184398 ",95.00,93786,99081,38,192905
"Bissam cuttack","Orissa",4994,4410,10,9414,"1144 ","199939 ",98.00,"197505 ",96.00,95088,108777,34,203899
"Rayagada","Orissa",6633,6718,8,13359,"1082 ","211702 ",99.00,"211352 ",99.00,102303,110692,49,213044
"Laxmipur","Orissa",3924,3948,0,7872,"1081 ","151593 ",98.00,"151261 ",98.00,73770,79765,3,153538
"Kotpad","Orissa",3321,2856,0,6177,"1036 ","178048 ",98.00,"177155 ",98.00,88667,91860,3,180530
"Jeypore","Orissa",3642,3211,3,6856,"1033 ","179418 ",95.00,"176760 ",94.00,92009,95013,14,187036
"Koraput","Orissa",3122,2829,0,5951,"1016 ","164702 ",98.00,"164292 ",98.00,82551,83849,4,166404
"Pottangi","Orissa",3705,3446,0,7151,"1043 ","168427 ",97.00,"166827 ",96.00,84218,87860,2,172080
"Malkangiri","Orissa",3987,3302,2,7291,"972 ","193598 ",98.00,"191907 ",98.00,99255,96479,5,195739
"Chitrakonda","Orissa",3602,3552,1,7155,"1041 ","161816 ",99.00,"161422 ",99.00,79623,82885,3,162511
"Mannadipet","Puducherry",609,545,0,1154,"1074 ","30095 ",100.00,"30095 ",100.00,14513,15581,1,30095
"Thirubhuvanai","Puducherry",593,559,0,1152,"1072 ","28512 ",100.00,"28512 ",100.00,13761,14751,0,28512
"Oussudu","Puducherry",521,483,0,1004,"1072 ","27128 ",100.00,"27128 ",100.00,13093,14035,0,27128
"Mangalam","Puducherry",656,565,0,1221,"1038 ","32277 ",100.00,"32277 ",100.00,15840,16436,1,32277
"Villianur","Puducherry",604,598,0,1202,"1033 ","33016 ",100.00,"33016 ",100.00,16238,16778,0,33016
"Ozhukarai","Puducherry",571,504,0,1075,"1045 ","33381 ",100.00,"33381 ",100.00,16325,17056,0,33381
"Kadirgamam","Puducherry",520,514,0,1034,"1051 ","31210 ",100.00,"31211 ",100.00,15217,15993,1,31211
"Indira Nagar","Puducherry",578,549,0,1127,"1075 ","32283 ",100.00,"32284 ",100.00,15558,16726,0,32284
"Thattanchavady","Puducherry",446,379,0,825,"1086 ","29018 ",100.00,"29021 ",100.00,13914,15106,1,29021
"Kamaraj Nagar","Puducherry",460,432,0,892,"1012 ","30659 ",100.00,"30659 ",100.00,15238,15421,0,30659
"Lawspet","Puducherry",453,425,0,878,"998 ","27610 ",100.00,"27612 ",100.00,13822,13789,1,27612
"Kalapet","Puducherry",568,490,0,1058,"1028 ","29461 ",100.00,"29461 ",100.00,14527,14934,0,29461
"Muthialpet","Puducherry",498,411,0,909,"1072 ","28205 ",100.00,"28205 ",100.00,13609,14594,2,28205
"Raj bhavan","Puducherry",362,310,0,672,"1117 ","25339 ",100.00,"25339 ",100.00,11967,13371,1,25339
"Oupalam","Puducherry",473,446,0,919,"1157 ","25962 ",100.00,"25962 ",100.00,12033,13928,1,25962
"Orleampeth","Puducherry",361,352,1,714,"1103 ","23309 ",100.00,"23309 ",100.00,11085,12223,1,23309
"Nellithope","Puducherry",411,443,0,854,"1077 ","28883 ",100.00,"28884 ",100.00,13905,14979,0,28884
"Mudaliarpet","Puducherry",545,495,0,1040,"1035 ","30736 ",100.00,"30738 ",100.00,15105,15633,0,30738
"Ariankuppam","Puducherry",556,467,0,1023,"1082 ","33560 ",100.00,"33560 ",100.00,16121,17439,0,33560
"Manavely","Puducherry",561,479,0,1040,"1078 ","29217 ",100.00,"29217 ",100.00,14059,15156,2,29217
"Embalam","Puducherry",632,532,0,1164,"1120 ","29630 ",100.00,"29630 ",100.00,13977,15653,0,29630
"Nettapakkam","Puducherry",563,517,0,1080,"1139 ","29547 ",100.00,"29548 ",100.00,13812,15736,0,29548
"Bahour","Puducherry",525,457,0,982,"1126 ","26747 ",100.00,"26747 ",100.00,12580,14167,0,26747
"Nedungadu","Puducherry",508,421,0,929,"1096 ","29264 ",100.00,"29264 ",100.00,13965,15299,0,29264
"Thirunallar","Puducherry",456,368,0,824,"1117 ","28932 ",100.00,"28932 ",100.00,13664,15268,0,28932
"Karaikal North","Puducherry",562,417,0,979,"1097 ","29782 ",100.00,"29782 ",100.00,14203,15579,0,29782
"Karaikal South","Puducherry",455,418,0,873,"1129 ","29402 ",100.00,"29402 ",100.00,13812,15590,0,29402
"Neravy T.R. Pattinam","Puducherry",520,389,0,909,"1115 ","29052 ",100.00,"29052 ",100.00,13736,15316,0,29052
"Mahe","Puducherry",276,239,0,515,"1262 ","29679 ",100.00,"29724 ",100.00,13140,16584,0,29724
"Yanam","Puducherry",658,481,0,1139,"1076 ","33506 ",100.00,"33506 ",100.00,16139,17367,0,33506
"Sujanpur","Punjab",2582,1596,0,4178,"916 ","153946 ",100.00,"153946 ",100.00,80329,73617,0,153946
"Bhoa","Punjab",3086,2064,0,5150,"922 ","165401 ",100.00,"165401 ",100.00,86044,79357,0,165401
"Pathankot","Punjab",1911,1221,0,3132,"933 ","139712 ",100.00,"139712 ",100.00,72269,67443,0,139712
"Gurdaspur","Punjab",2568,1439,0,4007,"923 ","152310 ",100.00,"152310 ",100.00,79197,73113,0,152310
"Dina Nagar","Punjab",3140,1919,0,5059,"912 ","178197 ",100.00,"178197 ",100.00,93215,84982,0,178197
"Qadian","Punjab",3237,1972,0,5209,"906 ","176659 ",100.00,"176659 ",100.00,92671,83988,0,176659
"Batala","Punjab",2460,1213,0,3673,"910 ","176031 ",100.00,"176031 ",100.00,92179,83852,0,176031
"Sri Hargobindpur","Punjab",3334,1756,0,5090,"934 ","165172 ",100.00,"165172 ",100.00,85404,79768,0,165172
"Fatehgarh Churian","Punjab",2778,1483,0,4261,"913 ","155307 ",100.00,"155307 ",100.00,81181,74126,0,155307
"Dera baba nanak","Punjab",3433,1952,0,5385,"933 ","174834 ",100.00,"174834 ",100.00,90455,84379,0,174834
"Ajnala","Punjab",2592,1541,0,4133,"938 ","146445 ",100.00,"146445 ",100.00,75546,70899,0,146445
"Raja sansi","Punjab",2652,1578,0,4230,"932 ","164694 ",100.00,"164694 ",100.00,85253,79441,0,164694
"Majitha","Punjab",2615,1474,0,4089,"924 ","151134 ",100.00,"151134 ",100.00,78562,72572,0,151134
"Jandiala","Punjab",2802,1353,0,4155,"905 ","167681 ",100.00,"167681 ",100.00,88002,79679,0,167681
"Amritsar North","Punjab",1458,849,0,2307,"918 ","176333 ",100.00,"176333 ",100.00,91928,84405,0,176333
"Amritsar West","Punjab",1534,878,0,2412,"876 ","182865 ",100.00,"182865 ",100.00,97451,85414,0,182865
"Amritsar Central","Punjab",1115,626,0,1741,"876 ","142152 ",100.00,"142152 ",100.00,75766,66386,0,142152
"Amritsar East","Punjab",1568,885,0,2453,"885 ","156191 ",100.00,"156191 ",100.00,82870,73321,0,156191
"Amritsar South","Punjab",1299,728,0,2027,"884 ","151914 ",100.00,"151914 ",100.00,80625,71289,0,151914
"Attari","Punjab",3200,1520,0,4720,"845 ","169228 ",100.00,"169228 ",100.00,91703,77525,0,169228
"Tarn taran","Punjab",3164,1782,0,4946,"915 ","173205 ",100.00,"173205 ",100.00,90435,82770,0,173205
"Khem karan","Punjab",3285,1798,0,5083,"934 ","193247 ",100.00,"193247 ",100.00,99944,93303,0,193247
"Patti","Punjab",3427,1910,0,5337,"935 ","184515 ",100.00,"184515 ",100.00,95343,89172,0,184515
"Khadoor Sahib","Punjab",3726,2039,0,5765,"907 ","184299 ",100.00,"184299 ",100.00,96645,87654,0,184299
"Baba bakala","Punjab",3269,1750,0,5019,"928 ","182247 ",100.00,"182247 ",100.00,94537,87710,0,182247
"Bholath","Punjab",2439,1484,0,3923,"995 ","125481 ",100.00,"125481 ",100.00,62900,62581,0,125481
"Kapurthala","Punjab",2214,1399,0,3613,"896 ","136833 ",100.00,"136833 ",100.00,72154,64679,0,136833
"Sultanpur lodhi","Punjab",3005,1842,0,4847,"904 ","135034 ",100.00,"135034 ",100.00,70925,64109,0,135034
"Phagwara","Punjab",3017,2119,0,5136,"908 ","168087 ",100.00,"168087 ",100.00,88117,79970,0,168087
"Phillaur","Punjab",2951,2125,0,5076,"938 ","189736 ",100.00,"189736 ",100.00,97898,91838,0,189736
"Nakodar","Punjab",2759,1757,0,4516,"941 ","181375 ",100.00,"181375 ",100.00,93442,87933,0,181375
"Shahkot","Punjab",3321,2294,0,5615,"951 ","166557 ",100.00,"166557 ",100.00,85380,81177,0,166557
"Kartarpur","Punjab",2919,1828,0,4747,"932 ","165157 ",100.00,"165157 ",100.00,85485,79672,0,165157
"Jalandhar West","Punjab",1389,966,0,2355,"900 ","148482 ",100.00,"148482 ",100.00,78157,70325,0,148482
"Jalandhar central","Punjab",1597,923,0,2520,"922 ","153333 ",100.00,"153333 ",100.00,79766,73567,0,153333
"Jalandhar North","Punjab",1482,933,0,2415,"891 ","166054 ",100.00,"166054 ",100.00,87791,78264,0,166055
"Jalandhar Cantt.","Punjab",2110,1422,0,3532,"850 ","189230 ",100.00,"189230 ",100.00,102276,86954,0,189230
"Adampur","Punjab",2459,1623,0,4082,"939 ","153741 ",100.00,"153741 ",100.00,79291,74450,0,153741
"Mukerian","Punjab",3044,2142,0,5186,"975 ","177739 ",100.00,"177737 ",100.00,90002,87742,0,177744
"Dasuya","Punjab",2997,2074,0,5071,"985 ","176957 ",100.00,"176957 ",100.00,89134,87827,0,176961
"Urmar","Punjab",2204,1406,0,3610,"992 ","163694 ",100.00,"163694 ",100.00,82156,81538,0,163694
"Sham chaurasi","Punjab",2265,1339,0,3604,"948 ","158635 ",100.00,"158633 ",100.00,81440,77195,0,158635
"Hoshiarpur","Punjab",1506,966,0,2472,"920 ","162342 ",100.00,"162342 ",100.00,84544,77798,0,162342
"Chabbewal","Punjab",2385,1539,0,3924,"934 ","149983 ",100.00,"149983 ",100.00,77552,72431,0,149983
"Garhshankar","Punjab",2811,1873,0,4684,"930 ","163476 ",100.00,"163476 ",100.00,84706,78770,0,163476
"Banga(SC)","Punjab",2535,1856,0,4391,"959 ","153042 ",100.00,"153042 ",100.00,78129,74913,0,153042
"Nawanshahr","Punjab",2715,1848,0,4563,"964 ","158575 ",100.00,"158575 ",100.00,80734,77841,0,158575
"Balachaur","Punjab",2778,1912,0,4690,"921 ","141436 ",100.00,"141436 ",100.00,73613,67823,0,141436
"Anandpur Sahib","Punjab",3134,1787,0,4921,"927 ","182505 ",100.00,"182505 ",100.00,94728,87777,0,182505
"Rupnagar","Punjab",2584,1600,0,4184,"907 ","161887 ",100.00,"161887 ",100.00,84898,76989,0,161887
"Chamkaur Sahib","Punjab",3247,1759,0,5006,"880 ","177953 ",100.00,"177953 ",100.00,94675,83278,0,177953
"Kharar","Punjab",2783,1313,0,4096,"872 ","194513 ",100.00,"194513 ",100.00,103891,90622,0,194513
"S.A.S.Nagar","Punjab",2092,1190,0,3282,"900 ","193572 ",100.00,"193572 ",100.00,101907,91665,0,193572
"Bassi Pathana","Punjab",2520,1423,0,3943,"890 ","138783 ",100.00,"138783 ",100.00,73449,65334,0,138783
"Fatehgarh Sahib","Punjab",2427,1365,0,3792,"906 ","144010 ",100.00,"144010 ",100.00,75573,68437,0,144010
"Amloh","Punjab",2349,1234,0,3583,"889 ","126649 ",100.00,"126648 ",100.00,67039,59610,0,126649
"Khanna","Punjab",2301,1308,0,3609,"903 ","154382 ",100.00,"154382 ",100.00,81129,73253,0,154382
"Samrala","Punjab",2867,1660,0,4527,"899 ","161783 ",100.00,"161783 ",100.00,85183,76600,0,161783
"Sahnewal","Punjab",3672,1936,0,5608,"839 ","199021 ",100.00,"199021 ",100.00,108194,90827,0,199021
"Ludhiana East","Punjab",1922,924,0,2846,"824 ","167114 ",100.00,"167114 ",100.00,91608,75506,0,167114
"Ludhiana South","Punjab",1451,630,0,2081,"759 ","142023 ",100.00,"142023 ",100.00,80746,61277,0,142023
"Atam Nagar","Punjab",1417,685,0,2102,"895 ","151867 ",100.00,"151867 ",100.00,80150,71717,0,151867
"Ludhiana central","Punjab",1500,781,0,2281,"865 ","144160 ",100.00,"144160 ",100.00,77284,66876,0,144160
"Ludhiana West","Punjab",1640,1030,0,2670,"922 ","171407 ",100.00,"171407 ",100.00,89196,82211,0,171407
"Ludhiana North","Punjab",1783,934,0,2717,"873 ","177729 ",100.00,"177729 ",100.00,94900,82829,0,177729
"Gill","Punjab",4001,2462,0,6463,"881 ","224654 ",100.00,"224654 ",100.00,119459,105195,0,224654
"Payal","Punjab",2870,1568,0,4438,"880 ","154745 ",100.00,"154745 ",100.00,82304,72441,0,154745
"Dakha","Punjab",3425,2160,0,5585,"897 ","174614 ",100.00,"174614 ",100.00,92054,82560,0,174614
"Raikot","Punjab",2648,1586,0,4234,"890 ","145967 ",100.00,"145967 ",100.00,77223,68744,0,145967
"Jagraon","Punjab",2788,1578,0,4366,"881 ","170873 ",100.00,"170873 ",100.00,90865,80008,0,170873
"Nihal Singh Wala","Punjab",3230,2114,0,5344,"883 ","188372 ",100.00,"188372 ",100.00,100052,88320,0,188372
"Bhagha Purana","Punjab",2698,1586,0,4284,"879 ","161889 ",100.00,"161889 ",100.00,86144,75745,0,161889
"Moga","Punjab",2574,1652,0,4226,"900 ","185419 ",100.00,"185419 ",100.00,97601,87818,0,185419
"Dharamkot","Punjab",2945,1863,0,4808,"900 ","168297 ",100.00,"168297 ",100.00,88589,79708,0,168297
"Zira","Punjab",3376,2022,0,5398,"909 ","174702 ",100.00,"174702 ",100.00,91505,83197,0,174702
"Firozpur City","Punjab",2296,1347,0,3643,"797 ","181555 ",100.00,"181555 ",100.00,101047,80508,0,181555
"Firozpur Rural","Punjab",3473,1983,0,5456,"909 ","174025 ",100.00,"174025 ",100.00,91145,82880,0,174025
"Guru har sahai","Punjab",2833,1785,0,4618,"936 ","149850 ",100.00,"149850 ",100.00,77399,72451,0,149850
"Jalalabad","Punjab",4022,2522,0,6544,"921 ","186886 ",100.00,"186886 ",100.00,97283,89603,0,186886
"Fazilka","Punjab",3585,2119,0,5704,"894 ","160052 ",100.00,"160052 ",100.00,84524,75528,0,160052
"Abohar","Punjab",2308,1082,0,3390,"860 ","155997 ",100.00,"155997 ",100.00,83867,72130,0,155997
"Balluana","Punjab",3014,1197,0,4211,"855 ","167289 ",100.00,"167289 ",100.00,90196,77093,0,167289
"Lambi","Punjab",2928,1562,0,4490,"906 ","149624 ",100.00,"149624 ",100.00,78513,71111,0,149624
"Gidderbaha","Punjab",2698,1610,0,4308,"904 ","149262 ",100.00,"149262 ",100.00,78397,70865,0,149262
"Malout","Punjab",2686,1291,0,3977,"881 ","158719 ",100.00,"158719 ",100.00,84396,74323,0,158719
"Muktsar","Punjab",2807,1630,0,4437,"903 ","164263 ",100.00,"164263 ",100.00,86315,77948,0,164263
"Faridkot","Punjab",2530,1452,0,3982,"925 ","144876 ",100.00,"144876 ",100.00,75268,69608,0,144876
"Kotkapura","Punjab",2218,1282,0,3500,"888 ","144208 ",100.00,"144208 ",100.00,76369,67839,0,144208
"Jaitu","Punjab",2466,1202,0,3668,"880 ","137479 ",100.00,"137479 ",100.00,73126,64356,0,137482
"Rampura Phul","Punjab",2659,1516,0,4175,"887 ","153239 ",100.00,"153239 ",100.00,81218,72021,0,153239
"Bhucho Mandi","Punjab",3298,1775,0,5073,"884 ","171602 ",100.00,"171602 ",100.00,91070,80532,0,171602
"Bathinda urban","Punjab",2004,1161,0,3165,"894 ","195360 ",100.00,"195358 ",100.00,103140,92224,0,195364
"Bathinda Rural","Punjab",2727,1398,0,4125,"833 ","147895 ",100.00,"147895 ",100.00,80678,67217,0,147895
"Talwandi Sabo","Punjab",2782,1246,0,4028,"866 ","143033 ",100.00,"143029 ",100.00,76667,66368,0,143035
"Maur","Punjab",2743,1404,0,4147,"877 ","152720 ",100.00,"152718 ",100.00,81380,71340,0,152720
"Mansa","Punjab",3233,1489,0,4722,"871 ","196366 ",100.00,"196366 ",100.00,104972,91394,0,196366
"Sardulgarh","Punjab",3055,1530,0,4585,"878 ","164438 ",100.00,"164438 ",100.00,87546,76892,0,164438
"Budhlada","Punjab",3600,1777,0,5377,"862 ","175458 ",100.00,"175458 ",100.00,94226,81232,0,175458
"Lehra","Punjab",3064,1121,0,4185,"872 ","153463 ",100.00,"153463 ",100.00,81977,71486,0,153463
"Dirba","Punjab",2736,1025,0,3761,"847 ","165343 ",100.00,"165343 ",100.00,89515,75828,0,165343
"Sunam","Punjab",3380,1656,0,5036,"886 ","176671 ",100.00,"176671 ",100.00,93688,82983,0,176671
"Bhadaur","Punjab",2504,1176,0,3680,"875 ","143686 ",100.00,"143686 ",100.00,76624,67062,0,143686
"Barnala","Punjab",2110,1139,0,3249,"884 ","159057 ",100.00,"159057 ",100.00,84404,74653,0,159057
"Mehal kalan","Punjab",2805,1683,0,4488,"893 ","147877 ",100.00,"147877 ",100.00,78130,69747,0,147877
"Malerkotla","Punjab",2206,1200,0,3406,"871 ","139718 ",100.00,"139718 ",100.00,74660,65058,0,139718
"Amargarh","Punjab",2690,1498,0,4188,"888 ","148558 ",100.00,"148558 ",100.00,78697,69861,0,148558
"Dhuri","Punjab",2447,1251,0,3698,"887 ","148279 ",100.00,"148279 ",100.00,78580,69699,0,148279
"Sangrur","Punjab",2884,1489,0,4373,"897 ","168213 ",100.00,"168213 ",100.00,88690,79523,0,168213
"Nabha","Punjab",2614,1467,0,4081,"894 ","166775 ",100.00,"166775 ",100.00,88058,78717,0,166775
"Patiala Rural","Punjab",2432,1401,0,3833,"920 ","193377 ",100.00,"193376 ",100.00,100736,92642,0,193378
"Rajpura","Punjab",2387,929,0,3316,"882 ","158439 ",100.00,"158439 ",100.00,84178,74261,0,158439
"Dera bassi","Punjab",3212,1461,0,4673,"891 ","208690 ",100.00,"208690 ",100.00,110358,98332,0,208690
"Ghanaur","Punjab",1577,634,0,2211,"852 ","148279 ",100.00,"148279 ",100.00,80070,68209,0,148279
"Sanour","Punjab",3828,1857,0,5685,"898 ","194765 ",100.00,"194765 ",100.00,102618,92147,0,194765
"Patiala","Punjab",1413,825,0,2238,"906 ","149365 ",100.00,"149365 ",100.00,78385,70980,0,149365
"Samana","Punjab",3172,1826,0,4998,"904 ","166197 ",100.00,"166197 ",100.00,87287,78910,0,166197
"Shutrana","Punjab",3054,1483,0,4537,"889 ","158674 ",100.00,"158674 ",100.00,84008,74666,0,158674
"Sadulshahar","Rajasthan",6174,5471,0,11645,"885 ","197222 ",100.00,"197222 ",100.00,104647,92575,0,197222
"Ganganagar","Rajasthan",4846,2936,0,7782,"900 ","197527 ",100.00,"197527 ",100.00,103953,93574,0,197527
"Karanpur","Rajasthan",3807,3231,0,7038,"892 ","200241 ",100.00,"200241 ",100.00,105862,94379,0,200241
"Suratgarh","Rajasthan",4961,3856,0,8817,"876 ","208296 ",100.00,"208296 ",100.00,111041,97255,0,208296
"Raisingh Nagar","Rajasthan",7934,5704,0,13638,"884 ","218681 ",100.00,"218681 ",100.00,116099,102582,0,218681
"Anupgarh","Rajasthan",8020,5379,0,13399,"877 ","200002 ",100.00,"200002 ",100.00,106579,93423,0,200002
"Sangaria","Rajasthan",4300,3878,0,8178,"896 ","206516 ",100.00,"206516 ",100.00,108898,97618,0,206516
"Hanumangarh","Rajasthan",5623,3417,0,9040,"888 ","241209 ",100.00,"241209 ",100.00,127743,113466,0,241209
"Pilibanga","Rajasthan",5124,4776,0,9900,"886 ","237812 ",100.00,"237812 ",100.00,126061,111751,0,237812
"Nohar","Rajasthan",8534,6631,0,15165,"863 ","226433 ",100.00,"226433 ",100.00,121553,104880,0,226433
"Bhadra","Rajasthan",6129,4668,0,10797,"877 ","228780 ",100.00,"228780 ",100.00,121871,106909,0,228780
"Khajuwala","Rajasthan",3545,2341,0,5886,"856 ","180164 ",100.00,"180164 ",100.00,97072,83092,0,180164
"Bikaner West","Rajasthan",3324,3267,0,6591,"881 ","184895 ",100.00,"184895 ",100.00,98275,86620,0,184895
"Bikaner East","Rajasthan",5154,6086,0,11240,"896 ","202041 ",100.00,"202041 ",100.00,106559,95482,0,202041
"Kolayat","Rajasthan",7524,6409,0,13933,"856 ","197088 ",100.00,"197088 ",100.00,106164,90924,0,197088
"Lunkaransar","Rajasthan",4491,3104,0,7595,"884 ","198636 ",100.00,"198636 ",100.00,105437,93199,0,198636
"Dungargarh","Rajasthan",5260,3483,0,8743,"895 ","202635 ",100.00,"202635 ",100.00,106923,95712,0,202635
"Nokha","Rajasthan",4077,2434,0,6511,"877 ","209612 ",100.00,"209612 ",100.00,111674,97938,0,209612
"Sadulpur","Rajasthan",7309,5658,0,12967,"896 ","196464 ",100.00,"196464 ",100.00,103598,92866,0,196464
"Taranagar","Rajasthan",5311,3447,0,8758,"892 ","207485 ",100.00,"207485 ",100.00,109650,97835,0,207485
"Sardarshahar","Rajasthan",5841,4496,0,10337,"887 ","236339 ",100.00,"236339 ",100.00,125251,111088,0,236339
"Churu","Rajasthan",4663,2796,0,7459,"907 ","202015 ",100.00,"202015 ",100.00,105959,96056,0,202015
"Ratangarh","Rajasthan",7580,5094,0,12674,"904 ","215733 ",100.00,"215733 ",100.00,113300,102433,0,215733
"Sujangarh","Rajasthan",8445,6680,0,15125,"908 ","226872 ",100.00,"226872 ",100.00,118890,107981,1,226872
"Pilani","Rajasthan",4941,2763,0,7704,"931 ","206205 ",100.00,"206205 ",100.00,106782,99423,0,206205
"Surajgarh","Rajasthan",5234,4876,0,10110,"931 ","232670 ",99.00,"232590 ",99.00,120581,112314,0,232895
"Jhunjhunu","Rajasthan",4025,3709,0,7734,"936 ","211800 ",100.00,"211800 ",100.00,109418,102382,0,211800
"Mandawa","Rajasthan",4531,3137,0,7668,"929 ","198732 ",100.00,"198732 ",100.00,103044,95688,0,198732
"Nawalgarh","Rajasthan",7254,6908,0,14162,"897 ","225902 ",100.00,"225902 ",100.00,119055,106847,0,225902
"Udaipurwati","Rajasthan",4351,3783,0,8134,"874 ","200299 ",99.00,"200252 ",99.00,106926,93436,0,200362
"Khetri","Rajasthan",6483,4720,0,11203,"891 ","180106 ",99.00,"180047 ",99.00,95330,84921,0,180251
"Fatehpur","Rajasthan",6941,3918,0,10859,"886 ","203272 ",100.00,"203272 ",100.00,107768,95513,0,203281
"Lachhmangarh","Rajasthan",7357,4086,0,11443,"898 ","220788 ",99.00,"220724 ",99.00,116410,104570,0,220980
"Dhod","Rajasthan",8496,3878,0,12374,"892 ","221752 ",100.00,"221739 ",99.00,117190,104567,0,221757
"Sikar","Rajasthan",5347,2878,0,8225,"881 ","232553 ",100.00,"232545 ",100.00,123610,108943,0,232553
"Danta ramgarh","Rajasthan",10558,7848,0,18406,"882 ","228431 ",100.00,"228431 ",100.00,121349,107083,0,228432
"Khandela","Rajasthan",9922,4939,0,14861,"860 ","211196 ",99.00,"211156 ",99.00,113594,97732,0,211326
"Neem ka Thana","Rajasthan",6710,3961,0,10671,"857 ","214654 ",100.00,"214654 ",100.00,115585,99069,0,214654
"Srimadhopur","Rajasthan",10532,4695,0,15227,"856 ","223485 ",99.00,"223141 ",99.00,120995,103631,0,224626
"Kotputli","Rajasthan",7838,3940,0,11778,"866 ","184065 ",100.00,"184065 ",100.00,98621,85444,0,184065
"Viratnagar","Rajasthan",5499,3817,0,9316,"871 ","181979 ",100.00,"181979 ",100.00,97273,84706,0,181979
"Shahpura","Rajasthan",4246,2149,0,6395,"870 ","185782 ",100.00,"185782 ",100.00,99339,86443,0,185782
"Chomu","Rajasthan",6089,3597,0,9686,"889 ","194223 ",99.00,"194382 ",99.00,102935,91476,0,194411
"Phulera","Rajasthan",7337,5259,0,12596,"887 ","214833 ",96.00,"214833 ",96.00,118313,104977,0,223290
"Dudu","Rajasthan",4081,2395,0,6476,"904 ","205907 ",100.00,"205907 ",100.00,108139,97768,0,205907
"Jhotwara","Rajasthan",9815,7307,0,17122,"893 ","324315 ",100.00,"324315 ",100.00,171336,152979,0,324315
"Amber","Rajasthan",12352,9354,0,21706,"887 ","217983 ",100.00,"217983 ",100.00,115500,102483,0,217983
"Jamwa ramgarh","Rajasthan",5828,3357,0,9185,"866 ","182852 ",100.00,"182852 ",100.00,98013,84839,0,182852
"Hawa mahal","Rajasthan",4562,2811,0,7373,"848 ","217632 ",100.00,"217632 ",100.00,117763,99867,2,217632
"Vidhyadhar Nagar","Rajasthan",7814,5407,0,13221,"860 ","306984 ",100.00,"306984 ",100.00,165005,141979,0,306984
"Civil lines","Rajasthan",7163,5420,0,12583,"891 ","225144 ",100.00,"225144 ",100.00,119086,106058,0,225144
"Kishan pole","Rajasthan",5547,4596,0,10143,"860 ","194683 ",99.00,"194683 ",99.00,105738,90896,0,196634
"Adarsh Nagar","Rajasthan",7095,4548,0,11643,"851 ","221912 ",99.00,"221612 ",99.00,120702,102691,0,223393
"Malviya Nagar","Rajasthan",5000,4038,0,9038,"905 ","215355 ",100.00,"215355 ",100.00,113024,102331,0,215355
"Sanganer","Rajasthan",5207,3324,0,8531,"873 ","281156 ",100.00,"281156 ",100.00,150142,131014,0,281156
"Bagru","Rajasthan",2067,1005,0,3072,"858 ","261665 ",100.00,"261665 ",100.00,140827,120838,0,261665
"Bassi","Rajasthan",5188,3437,0,8625,"891 ","185713 ",100.00,"185713 ",100.00,98202,87511,0,185713
"Chaksu","Rajasthan",6121,3865,0,9986,"903 ","188285 ",100.00,"188285 ",100.00,98942,89343,0,188285
"Tijara","Rajasthan",5332,4514,1,9847,"870 ","184797 ",99.00,"184797 ",99.00,98828,85999,1,184828
"Kishangarh bas","Rajasthan",7868,4328,0,12196,"886 ","201423 ",99.00,"201416 ",99.00,106836,94640,0,201476
"Mundawar","Rajasthan",7637,4826,0,12463,"887 ","190709 ",99.00,"190548 ",99.00,101382,89923,0,191305
"Behror","Rajasthan",5269,1856,0,7125,"888 ","190737 ",100.00,"190737 ",100.00,101030,89707,0,190737
"Bansur","Rajasthan",8508,4980,0,13488,"855 ","190754 ",99.00,"190811 ",99.00,102971,88019,0,190990
"Thanagazi","Rajasthan",4917,2608,0,7525,"847 ","174519 ",99.00,"174410 ",99.00,94791,80304,0,175095
"Alwar Rural","Rajasthan",6223,2782,0,9005,"845 ","192035 ",99.00,"191904 ",99.00,104865,88637,0,193502
"Alwar urban","Rajasthan",6026,4560,0,10586,"888 ","218968 ",98.00,"217152 ",97.00,117786,104640,0,222426
"Ramgarh","Rajasthan",8823,4900,0,13723,"865 ","202268 ",99.00,"202010 ",99.00,108814,94110,0,202924
"Rajgarh laxmangarh","Rajasthan",8418,5275,0,13693,"858 ","212327 ",99.00,"212047 ",99.00,114367,98180,0,212547
"Kathumar","Rajasthan",7592,4953,0,12545,"852 ","182923 ",99.00,"182906 ",99.00,98840,84216,0,183056
"Kaman","Rajasthan",9284,6174,0,15458,"869 ","206194 ",99.00,"206194 ",99.00,110637,96146,0,206783
"Nagar","Rajasthan",5687,3129,0,8816,"865 ","194376 ",99.00,"194324 ",99.00,104806,90628,0,195434
"Deeg-kumher","Rajasthan",8816,5750,0,14566,"867 ","209039 ",99.00,"209037 ",99.00,111991,97067,1,209059
"Bharatpur","Rajasthan",6538,4554,0,11092,"866 ","224551 ",99.00,"224537 ",99.00,120409,104242,0,224651
"Nadbai","Rajasthan",7750,5303,0,13053,"857 ","229104 ",99.00,"228662 ",99.00,124038,106255,0,230293
"Weir","Rajasthan",9886,7348,0,17234,"846 ","215774 ",100.00,"215774 ",100.00,116856,98918,0,215774
"Bayana","Rajasthan",8115,5159,0,13274,"838 ","207665 ",99.00,"207664 ",99.00,113011,94687,0,207698
"Baseri","Rajasthan",5029,2593,0,7622,"820 ","154732 ",100.00,"154732 ",100.00,85028,69704,0,154732
"Bari","Rajasthan",6586,3783,0,10369,"838 ","182855 ",99.00,"182850 ",99.00,99496,83376,0,182872
"Dholpur","Rajasthan",7356,4697,0,12053,"861 ","168664 ",99.00,"168640 ",99.00,90713,78085,0,168798
"Rajakhera","Rajasthan",5783,2835,0,8618,"814 ","167023 ",100.00,"167023 ",100.00,92080,74943,0,167023
"Todabhim","Rajasthan",6957,4488,0,11445,"844 ","226936 ",99.00,"226886 ",99.00,124075,104746,0,228821
"Hindaun","Rajasthan",6338,2783,0,9121,"848 ","209398 ",99.00,"209398 ",99.00,114096,96696,0,210792
"Karauli","Rajasthan",7235,3922,0,11157,"823 ","200946 ",99.00,"200946 ",99.00,110759,91187,0,201946
"Sapotra","Rajasthan",9724,5406,0,15130,"816 ","218110 ",100.00,"218110 ",100.00,120120,97990,0,218110
"Bandikui","Rajasthan",5945,3268,0,9213,"880 ","182629 ",100.00,"182629 ",100.00,97144,85485,0,182629
"Mahuwa","Rajasthan",5138,2262,0,7400,"852 ","173733 ",99.00,"173656 ",99.00,94051,80126,0,174177
"Sikrai","Rajasthan",6371,3269,0,9640,"857 ","209478 ",99.00,"209478 ",99.00,112890,96727,0,209617
"Dausa","Rajasthan",6123,3251,0,9374,"871 ","196880 ",99.00,"196880 ",99.00,105438,91860,0,197298
"Lalsot","Rajasthan",5966,3098,0,9064,"861 ","201325 ",99.00,"201325 ",99.00,108214,93158,0,201372
"Gangapur","Rajasthan",5528,4709,0,10237,"834 ","205790 ",99.00,"205759 ",99.00,112306,93639,0,205945
"Bamanwas","Rajasthan",4762,3962,0,8724,"829 ","196275 ",99.00,"196287 ",99.00,107404,89049,0,196453
"Sawai madhopur","Rajasthan",4873,4234,0,9107,"863 ","213327 ",100.00,"213327 ",100.00,114515,98812,0,213327
"Khandar","Rajasthan",5403,4602,0,10005,"844 ","199955 ",99.00,"199895 ",99.00,108584,91671,0,200255
"Malpura","Rajasthan",6191,4442,0,10633,"927 ","221138 ",99.00,"221122 ",99.00,114905,106553,0,221458
"Niwai","Rajasthan",5367,3668,0,9035,"895 ","218701 ",99.00,"218685 ",99.00,115432,103351,0,218783
"Tonk","Rajasthan",4830,3618,0,8448,"917 ","199071 ",100.00,"199071 ",100.00,103847,95224,0,199071
"Deoli - uniara","Rajasthan",5092,4253,0,9345,"905 ","237527 ",99.00,"237539 ",99.00,124743,112916,0,237659
"Kishangarh","Rajasthan",5893,4644,0,10537,"920 ","237728 ",99.00,"237701 ",99.00,123839,113943,0,237782
"Pushkar","Rajasthan",3508,2778,0,6286,"933 ","201122 ",99.00,"201119 ",99.00,104031,97104,0,201135
"Ajmer North","Rajasthan",4050,3254,0,7304,"956 ","189879 ",99.00,"188815 ",99.00,97141,92872,0,190013
"Ajmer South","Rajasthan",3347,2645,0,5992,"962 ","187522 ",99.00,"187522 ",99.00,96107,92415,0,188522
"Nasirabad","Rajasthan",6091,4053,0,10144,"929 ","192269 ",99.00,"192248 ",99.00,99768,92653,1,192422
"Beawar","Rajasthan",5135,4024,0,9159,"964 ","220514 ",99.00,"220365 ",99.00,112300,108267,0,220567
"Masuda","Rajasthan",6371,4187,0,10558,"941 ","227623 ",99.00,"227623 ",99.00,118018,111100,0,229118
"Kekri","Rajasthan",3275,5756,0,9031,"1087 ","206435 ",95.00,"214621 ",99.00,103773,112847,0,216620
"Ladnun","Rajasthan",6871,3423,0,10294,"901 ","205887 ",99.00,"205315 ",99.00,108496,97701,0,206197
"Deedwana","Rajasthan",7227,4710,0,11937,"920 ","207246 ",100.00,"207015 ",99.00,107936,99310,0,207246
"Jayal","Rajasthan",6063,4799,0,10862,"907 ","206117 ",99.00,"205702 ",99.00,108535,98444,0,206979
"Nagaur","Rajasthan",6090,3458,0,9548,"891 ","209142 ",99.00,"209142 ",99.00,110787,98765,0,209552
"Khinwsar","Rajasthan",5979,2493,0,8472,"868 ","211167 ",100.00,"211077 ",99.00,113068,98099,0,211167
"Merta","Rajasthan",5758,3630,0,9388,"898 ","227825 ",99.00,"227745 ",99.00,120140,107903,0,228043
"Degana","Rajasthan",7253,4021,0,11274,"904 ","213795 ",100.00,"213795 ",100.00,112270,101525,0,213795
"Makrana","Rajasthan",6394,4813,0,11207,"889 ","212443 ",99.00,"212025 ",99.00,113083,100571,0,213654
"Parbatsar","Rajasthan",4515,2351,0,6866,"882 ","192661 ",98.00,"191679 ",98.00,103536,91354,2,194892
"Nawan","Rajasthan",6151,4403,0,10554,"895 ","209886 ",98.00,"209825 ",98.00,112052,100270,0,212322
"Jaitaran","Rajasthan",3914,2455,0,6369,"915 ","246381 ",100.00,"246381 ",100.00,128655,117726,0,246381
"Sojat","Rajasthan",4045,3749,0,7794,"931 ","200004 ",100.00,"200004 ",100.00,103591,96413,0,200004
"Pali","Rajasthan",6418,4213,0,10631,"891 ","217753 ",100.00,"217753 ",100.00,115158,102595,0,217753
"Marwar junction","Rajasthan",5089,2917,0,8006,"895 ","242562 ",100.00,"242562 ",100.00,127975,114584,3,242562
"Bali","Rajasthan",6700,5000,0,11700,"905 ","275928 ",100.00,"275932 ",100.00,144841,131100,0,275941
"Sumerpur","Rajasthan",5833,3337,0,9170,"897 ","252048 ",100.00,"252048 ",100.00,132865,119183,0,252048
"Phalodi","Rajasthan",6435,5208,0,11643,"893 ","201852 ",100.00,"201852 ",100.00,106649,95203,0,201852
"Lohawat","Rajasthan",6829,5696,0,12525,"897 ","206191 ",100.00,"206191 ",100.00,108713,97478,0,206191
"Shergarh","Rajasthan",5238,3095,0,8333,"891 ","207526 ",95.00,"207526 ",95.00,115020,102511,0,217531
"Osian","Rajasthan",7044,4582,0,11626,"896 ","205867 ",99.00,"205567 ",99.00,109018,97729,0,206747
"Bhopalgarh","Rajasthan",8192,6428,0,14620,"904 ","248028 ",100.00,"248028 ",100.00,130262,117766,0,248028
"Sardarpura","Rajasthan",3860,2485,0,6345,"922 ","213139 ",99.00,"213064 ",99.00,111095,102392,0,213487
"Jodhpur","Rajasthan",4099,3095,0,7194,"939 ","193442 ",99.00,"193142 ",99.00,100335,94197,0,194532
"Soorsagar","Rajasthan",4267,2783,0,7050,"880 ","237716 ",99.00,"237552 ",99.00,127000,111751,0,238751
"Luni","Rajasthan",5422,2963,0,8385,"882 ","256783 ",99.00,"256592 ",99.00,137114,120943,0,258057
"Bilara","Rajasthan",4059,2330,0,6389,"915 ","241082 ",100.00,"241082 ",100.00,125924,115158,0,241082
"Jaisalmer","Rajasthan",5286,3100,0,8386,"861 ","197656 ",99.00,"197291 ",99.00,106794,92000,3,198797
"Pokaran","Rajasthan",3829,2811,0,6640,"899 ","168629 ",99.00,"168533 ",99.00,88897,79955,0,168852
"Sheo","Rajasthan",4231,3434,0,7665,"867 ","226546 ",99.00,"226546 ",99.00,121414,105259,0,226673
"Barmer","Rajasthan",7550,6923,0,14473,"874 ","208601 ",100.00,"208601 ",100.00,111309,97292,0,208601
"Baytoo","Rajasthan",4792,2919,0,7711,"874 ","188583 ",99.00,"188583 ",99.00,100651,87978,0,188629
"Pachpadra","Rajasthan",6507,4060,0,10567,"885 ","200951 ",99.00,"200950 ",99.00,106680,94450,0,201130
"Siwana","Rajasthan",7942,5076,0,13018,"868 ","213463 ",100.00,"213420 ",99.00,114269,99194,0,213463
"Gudhamalani","Rajasthan",8774,6078,0,14852,"882 ","198680 ",100.00,"198680 ",100.00,105570,93110,0,198680
"Chohtan","Rajasthan",4283,3230,0,7513,"876 ","227747 ",99.00,"227747 ",99.00,121475,106425,0,227900
"Ahore","Rajasthan",4873,4092,0,8965,"901 ","223685 ",99.00,"223348 ",99.00,118135,106395,0,224530
"Jalore","Rajasthan",5681,3920,0,9601,"876 ","232343 ",99.00,"231579 ",98.00,124734,109270,0,234004
"Bhinmal","Rajasthan",6903,6294,0,13197,"899 ","249516 ",99.00,"249471 ",99.00,131407,118196,0,249603
"Sanchore","Rajasthan",7061,6041,0,13102,"887 ","241495 ",98.00,"240962 ",97.00,130538,115739,0,246277
"Raniwara","Rajasthan",8461,6409,0,14870,"907 ","214541 ",100.00,"214541 ",100.00,112512,102029,0,214541
"Sirohi","Rajasthan",4513,4281,0,8794,"882 ","236888 ",99.00,"236532 ",99.00,125955,111075,0,237030
"Pindwara abu","Rajasthan",4006,3965,0,7971,"905 ","183023 ",99.00,"182841 ",99.00,96094,86941,0,183035
"Reodar","Rajasthan",4838,5110,0,9948,"888 ","223785 ",99.00,"223587 ",99.00,118765,105463,0,224228
"Gogunda","Rajasthan",4750,4624,0,9374,"944 ","215551 ",99.00,"215443 ",99.00,111257,105073,0,216330
"Jhadol","Rajasthan",6328,4940,0,11268,"957 ","211719 ",100.00,"211719 ",100.00,108173,103546,0,211719
"Kherwara","Rajasthan",6617,5893,0,12510,"958 ","242233 ",99.00,"242233 ",99.00,123905,118680,0,242585
"Udaipur Rural","Rajasthan",5640,4188,0,9828,"947 ","226114 ",98.00,"225535 ",98.00,117611,111350,0,228961
"Udaipur","Rajasthan",6045,5476,0,11521,"963 ","222317 ",98.00,"220796 ",98.00,114753,110544,0,225297
"Mavli","Rajasthan",5852,3758,0,9610,"950 ","213776 ",99.00,"213712 ",99.00,109887,104350,0,214237
"Vallabh Nagar","Rajasthan",4708,4558,0,9266,"959 ","225963 ",99.00,"225946 ",99.00,115419,110724,0,226143
"Salumber","Rajasthan",5391,4051,0,9442,"942 ","236207 ",99.00,"235821 ",99.00,122573,115406,0,237979
"Dhariyawad","Rajasthan",6881,6676,0,13557,"961 ","220052 ",99.00,"219955 ",99.00,112776,108433,0,221209
"Dungarpur","Rajasthan",4652,3164,0,7816,"949 ","199482 ",99.00,"199352 ",99.00,102781,97558,0,200339
"Aspur","Rajasthan",5907,4493,0,10400,"954 ","218651 ",99.00,"218344 ",99.00,112633,107492,0,220125
"Sagwara","Rajasthan",5801,4182,0,9983,"947 ","216338 ",99.00,"216037 ",99.00,111334,105426,0,216760
"Chorasi","Rajasthan",4584,3135,0,7719,"950 ","189058 ",99.00,"188913 ",99.00,97206,92374,0,189580
"Ghatol","Rajasthan",4924,4308,0,9232,"973 ","221416 ",99.00,"221230 ",99.00,112580,109501,0,222081
"Garhi","Rajasthan",5939,4740,0,10679,"960 ","232339 ",99.00,"232339 ",99.00,119674,114872,0,234546
"Banswara","Rajasthan",7039,5792,0,12831,"969 ","223290 ",99.00,"223296 ",99.00,113438,109918,0,223356
"Bagidora","Rajasthan",5865,5073,0,10938,"956 ","205903 ",100.00,"205903 ",100.00,105254,100649,0,205903
"Kushalgarh","Rajasthan",2424,2232,0,4656,"959 ","194408 ",99.00,"194292 ",99.00,99336,95252,2,194590
"Kapasan","Rajasthan",4163,4001,0,8164,"966 ","231422 ",100.00,"231422 ",100.00,117717,113705,0,231422
"Begun","Rajasthan",4839,4548,0,9387,"935 ","236188 ",100.00,"236188 ",100.00,122035,114153,0,236188
"Chittorgarh","Rajasthan",4958,4055,0,9013,"957 ","225145 ",99.00,"225099 ",99.00,115139,110150,0,225289
"Nimbahera","Rajasthan",5126,4688,0,9814,"973 ","234212 ",100.00,"234212 ",100.00,118707,115505,0,234212
"Bari sadri","Rajasthan",4572,3756,0,8328,"960 ","228496 ",99.00,"228496 ",99.00,117172,112429,0,229601
"Pratapgarh","Rajasthan",4966,4743,0,9709,"963 ","209141 ",99.00,"209276 ",99.00,107019,103044,0,210063
"Bhim","Rajasthan",3729,2798,0,6527,"956 ","186003 ",99.00,"186003 ",99.00,95131,90955,1,186087
"Kumbhalgarh","Rajasthan",6837,5494,0,12331,"936 ","186814 ",99.00,"186853 ",99.00,96582,90372,0,186954
"Rajsamand","Rajasthan",3459,2241,0,5700,"949 ","195468 ",99.00,"195634 ",99.00,100391,95265,0,195656
"Nathdwara","Rajasthan",3333,2146,1,5480,"944 ","209444 ",99.00,"209397 ",99.00,107770,101715,4,209489
"Asind","Rajasthan",7322,5761,0,13083,"964 ","242532 ",99.00,"241767 ",99.00,123749,119306,0,243055
"Mandal","Rajasthan",6096,3751,0,9847,"952 ","214947 ",99.00,"214568 ",99.00,110195,104920,0,215115
"Sahara","Rajasthan",3469,2422,0,5891,"962 ","214115 ",99.00,"213980 ",99.00,109298,105163,0,214461
"Bhilwara","Rajasthan",10802,4680,0,15482,"912 ","224211 ",99.00,"223610 ",99.00,117546,107209,0,224755
"Shahpura","Rajasthan",6951,5559,0,12510,"950 ","209435 ",99.00,"209435 ",99.00,107996,102639,0,210635
"Jahazpur","Rajasthan",6156,4987,0,11143,"941 ","206557 ",99.00,"206425 ",99.00,106763,100481,0,207244
"Mandalgarh","Rajasthan",3837,3269,0,7106,"938 ","206986 ",99.00,"206598 ",99.00,107221,100587,0,207808
"Hindoli","Rajasthan",6438,5403,0,11841,"900 ","217149 ",99.00,"216377 ",99.00,114727,103237,0,217964
"Keshoraipatan","Rajasthan",6940,6504,0,13444,"898 ","230173 ",99.00,"229893 ",99.00,121735,109375,0,231110
"Bundi","Rajasthan",5646,3826,0,9472,"929 ","247822 ",100.00,"247822 ",100.00,128474,119348,0,247822
"Pipalda","Rajasthan",3911,2893,0,6804,"903 ","178471 ",100.00,"178471 ",100.00,93792,84679,0,178471
"Sangod","Rajasthan",5671,6314,0,11985,"903 ","179363 ",99.00,"179313 ",99.00,94345,85233,0,179578
"Kota North","Rajasthan",4684,3423,0,8107,"921 ","228269 ",99.00,"228263 ",99.00,118817,109476,0,228293
"Kota South","Rajasthan",5170,4319,0,9489,"925 ","238074 ",99.00,"238074 ",99.00,123709,114396,0,238105
"Ladpura","Rajasthan",5945,3736,0,9681,"897 ","229262 ",100.00,"229262 ",100.00,120862,108400,0,229262
"Ramganj mandi","Rajasthan",4220,2239,0,6459,"891 ","194323 ",100.00,"194323 ",100.00,102777,91546,0,194323
"Anta","Rajasthan",4905,3435,0,8340,"918 ","187435 ",99.00,"186740 ",98.00,98504,90424,0,188928
"Kishanganj","Rajasthan",3925,2734,0,6659,"920 ","183166 ",99.00,"183166 ",99.00,95389,87800,0,183189
"Baran-atru","Rajasthan",5460,3532,0,8992,"916 ","203367 ",98.00,"202643 ",98.00,107434,98451,0,205885
"Chhabra","Rajasthan",6093,4071,0,10164,"889 ","198042 ",99.00,"197840 ",99.00,105027,93326,0,198353
"Dag","Rajasthan",8000,6562,0,14562,"940 ","217622 ",99.00,"216857 ",99.00,112664,105862,0,218526
"Jhalrapatan","Rajasthan",7665,5557,0,13222,"927 ","239551 ",99.00,"239342 ",99.00,124672,115521,0,240193
"Khanpur","Rajasthan",7833,6352,0,14185,"927 ","207656 ",99.00,"207471 ",99.00,108056,100190,0,208246
"Manohar thana","Rajasthan",5830,5521,0,11351,"926 ","215437 ",99.00,"215261 ",99.00,112065,103795,0,215860
"Yoksam-tashiding","Sikkim",203,172,0,375,"901 ","11393 ",100.00,"11393 ",100.00,5993,5400,0,11393
"Yangthang","Sikkim",190,175,0,365,"967 ","10848 ",100.00,"10848 ",100.00,5516,5332,0,10848
"Maneybung-dentam","Sikkim",282,206,0,488,"937 ","12203 ",100.00,"12203 ",100.00,6300,5903,0,12203
"Gyalshing-barnyak","Sikkim",194,132,0,326,"914 ","10320 ",100.00,"10320 ",100.00,5393,4927,0,10320
"Rinchenpong","Sikkim",275,236,0,511,"903 ","12415 ",100.00,"12415 ",100.00,6525,5890,0,12415
"Daramdin","Sikkim",269,227,0,496,"968 ","13269 ",100.00,"13269 ",100.00,6742,6527,0,13269
"Soreong-chakung","Sikkim",278,201,0,479,"955 ","13758 ",100.00,"13758 ",100.00,7037,6721,0,13758
"Salghari-zoom","Sikkim",196,143,0,339,"903 ","9422 ",100.00,"9422 ",100.00,4950,4472,0,9422
"Barfung","Sikkim",200,160,0,360,"921 ","12156 ",100.00,"12156 ",100.00,6328,5828,0,12156
"Poklok-kamrang","Sikkim",221,184,0,405,"948 ","13222 ",100.00,"13222 ",100.00,6789,6433,0,13222
"Namchi-singhithang","Sikkim",174,140,0,314,"1014 ","10628 ",100.00,"10628 ",100.00,5277,5351,0,10628
"Melli","Sikkim",215,194,0,409,"983 ","13159 ",100.00,"13159 ",100.00,6636,6523,0,13159
"Namthang-rateypani","Sikkim",228,193,0,421,"983 ","12997 ",100.00,"12997 ",100.00,6555,6442,0,12997
"Temi-namphing","Sikkim",207,141,0,348,"973 ","12030 ",100.00,"12030 ",100.00,6098,5932,0,12030
"Rangang-yangang","Sikkim",213,178,0,391,"929 ","11583 ",100.00,"11583 ",100.00,6006,5577,0,11583
"Tumen-lingi","Sikkim",283,244,0,527,"964 ","13315 ",100.00,"13315 ",100.00,6780,6535,0,13315
"Khamdong-singtam","Sikkim",198,179,0,377,"913 ","11152 ",100.00,"11152 ",100.00,5830,5322,0,11152
"West pendam","Sikkim",233,199,0,432,"901 ","11987 ",100.00,"11987 ",100.00,6307,5680,0,11987
"Rhenock","Sikkim",269,219,0,488,"938 ","14957 ",100.00,"14957 ",100.00,7718,7239,0,14957
"Chujachen","Sikkim",214,146,0,360,"965 ","15018 ",100.00,"15018 ",100.00,7642,7376,0,15018
"Gnathang-machong","Sikkim",187,180,0,367,"959 ","9865 ",100.00,"9865 ",100.00,5037,4828,0,9865
"Namcheybung","Sikkim",210,164,0,374,"948 ","12604 ",100.00,"12604 ",100.00,6469,6135,0,12604
"Shyari","Sikkim",199,145,0,344,"949 ","12069 ",100.00,"12069 ",100.00,6192,5877,0,12069
"Martam-rumtek","Sikkim",277,242,0,519,"982 ","14177 ",100.00,"14177 ",100.00,7152,7025,0,14177
"Upper tadong","Sikkim",129,108,0,237,"1001 ","8696 ",100.00,"8696 ",100.00,4345,4351,0,8696
"Arithang","Sikkim",135,100,0,235,"895 ","9030 ",100.00,"9030 ",100.00,4764,4266,0,9030
"Gangtok","Sikkim",90,79,0,169,"891 ","9733 ",100.00,"9733 ",100.00,5147,4586,0,9733
"Upper burtuk","Sikkim",153,176,0,329,"978 ","12039 ",100.00,"12039 ",100.00,6087,5952,0,12039
"Kabi lungchuk","Sikkim",184,175,0,359,"1039 ","10776 ",100.00,"10776 ",100.00,5286,5490,0,10776
"Djongu","Sikkim",166,151,0,317,"1055 ","7994 ",100.00,"7994 ",100.00,3890,4104,0,7994
"Lachen mangan","Sikkim",93,110,0,203,"1067 ","6652 ",100.00,"6652 ",100.00,3218,3434,0,6652
"Sangha","Sikkim",51,0,0,51,"15 ","2859 ",100.00,"2859 ",100.00,2817,42,0,2859
"Gummidipoondi","Tamil Nadu",3519,2351,2,5872,"1020 ","238653 ",100.00,"238653 ",100.00,118133,120489,31,238653
"Ponneri","Tamil Nadu",2475,1675,0,4150,"1001 ","222072 ",100.00,"222072 ",100.00,110932,111085,55,222072
"Tiruttani","Tamil Nadu",3679,2574,0,6253,"1017 ","254401 ",100.00,"254401 ",100.00,126091,128292,18,254401
"Thiruvallur","Tamil Nadu",2652,1919,0,4571,"1011 ","228087 ",100.00,"228087 ",100.00,113418,114655,14,228087
"Poonamallee","Tamil Nadu",3436,2385,0,5821,"995 ","274187 ",100.00,"274187 ",100.00,137436,136715,36,274187
"Avadi","Tamil Nadu",4003,2955,3,6961,"975 ","343466 ",100.00,"343466 ",100.00,173845,169566,55,343466
"Maduravoyal","Tamil Nadu",3235,2599,3,5837,"957 ","332639 ",100.00,"332639 ",100.00,169980,162589,70,332639
"Ambattur","Tamil Nadu",2692,1992,3,4687,"961 ","298608 ",100.00,"298608 ",100.00,152238,146316,54,298608
"Madavaram","Tamil Nadu",3786,2676,0,6462,"985 ","343598 ",100.00,"343598 ",100.00,173102,170436,60,343598
"Thiruvottiyur","Tamil Nadu",3010,2257,1,5268,"988 ","255480 ",100.00,"255480 ",100.00,128490,126942,48,255480
"Dr.Radhakrishnan Nagar","Tamil Nadu",6030,4847,8,10885,"1020 ","225648 ",100.00,"225648 ",100.00,111649,113931,68,225648
"Perambur","Tamil Nadu",2872,2135,0,5007,"1006 ","259861 ",100.00,"259861 ",100.00,129557,130277,27,259861
"Kolathur","Tamil Nadu",2225,1869,1,4095,"1012 ","244229 ",100.00,"244229 ",100.00,121339,122842,48,244229
"Villivakkam","Tamil Nadu",4667,3843,5,8515,"1016 ","229661 ",100.00,"229661 ",100.00,113899,115725,37,229661
"Thiru-Vi-Ka-Nagar","Tamil Nadu",2098,1669,0,3767,"1029 ","210072 ",100.00,"210072 ",100.00,103514,106540,18,210072
"Egmore","Tamil Nadu",1706,1442,0,3148,"1007 ","178793 ",100.00,"178793 ",100.00,89070,89705,18,178793
"Royapuram","Tamil Nadu",1925,1587,0,3512,"1014 ","182045 ",100.00,"182045 ",100.00,90355,91661,29,182045
"Harbour","Tamil Nadu",1592,1133,0,2725,"901 ","173645 ",100.00,"173645 ",100.00,91328,82268,49,173645
"Chepauk-Thiruvallikeni","Tamil Nadu",2087,1747,0,3834,"1012 ","211532 ",100.00,"211532 ",100.00,105129,106393,10,211532
"Thousand Lights","Tamil Nadu",1947,1791,3,3741,"1020 ","224831 ",100.00,"224831 ",100.00,111259,113500,72,224831
"Anna Nagar","Tamil Nadu",2547,2227,0,4774,"1009 ","261789 ",100.00,"261789 ",100.00,130284,131464,41,261789
"Virugampakkam","Tamil Nadu",2365,1929,3,4297,"977 ","255651 ",100.00,"255651 ",100.00,129276,126328,47,255651
"Saidapet","Tamil Nadu",2871,2319,2,5192,"1005 ","255180 ",100.00,"255180 ",100.00,127268,127846,66,255180
"Thiyagarayanagar","Tamil Nadu",1917,1763,0,3680,"1000 ","220141 ",100.00,"220141 ",100.00,110059,110046,36,220141
"Mylapore","Tamil Nadu",2110,1727,1,3838,"1044 ","239525 ",100.00,"239525 ",100.00,117191,122306,28,239525
"Velachery","Tamil Nadu",2039,1668,0,3707,"998 ","263596 ",100.00,"263596 ",100.00,131899,131629,68,263596
"Shozhinganallur","Tamil Nadu",4311,3461,0,7772,"972 ","480894 ",100.00,"480894 ",100.00,243855,236993,46,480894
"Alandur","Tamil Nadu",2888,2111,0,4999,"988 ","297631 ",100.00,"297631 ",100.00,149705,147914,12,297631
"Sriperumbudur","Tamil Nadu",3449,2422,0,5871,"1014 ","253681 ",100.00,"253681 ",100.00,125952,127707,22,253681
"Pallavaram","Tamil Nadu",3310,2549,0,5859,"987 ","349440 ",100.00,"349440 ",100.00,175840,173570,30,349440
"Tambaram","Tamil Nadu",2800,2264,0,5064,"984 ","323505 ",100.00,"323505 ",100.00,163060,160405,40,323505
"Chengalpattu","Tamil Nadu",3304,2483,0,5787,"996 ","323369 ",100.00,"323369 ",100.00,161951,161352,66,323369
"Thiruporur","Tamil Nadu",2850,1909,0,4759,"987 ","224293 ",100.00,"224293 ",100.00,112888,111393,12,224293
"Cheyyur","Tamil Nadu",2664,1683,0,4347,"984 ","193411 ",100.00,"193411 ",100.00,97497,95892,22,193411
"Madurantakam","Tamil Nadu",2861,2216,0,5077,"1029 ","204220 ",100.00,"204220 ",100.00,100641,103564,15,204220
"Uthiramerur","Tamil Nadu",3486,2674,0,6160,"1014 ","224310 ",100.00,"224310 ",100.00,111377,112911,22,224310
"Kancheepuram","Tamil Nadu",4089,3142,0,7231,"1024 ","271788 ",100.00,"271788 ",100.00,134276,137494,18,271788
"Arakkonam","Tamil Nadu",2563,1814,0,4377,"1023 ","205752 ",100.00,"205752 ",100.00,101697,104047,8,205752
"Sholingur","Tamil Nadu",3605,2567,0,6172,"1009 ","241203 ",100.00,"241203 ",100.00,120040,121163,0,241203
"Katpadi","Tamil Nadu",2777,2047,0,4824,"1036 ","212774 ",100.00,"212774 ",100.00,104482,108279,13,212774
"Ranipet","Tamil Nadu",3433,2620,0,6053,"1033 ","229351 ",100.00,"229351 ",100.00,112826,116525,0,229351
"Arcot","Tamil Nadu",3479,2782,0,6261,"1032 ","232174 ",100.00,"232174 ",100.00,114263,117910,1,232174
"Vellore","Tamil Nadu",2201,1718,0,3919,"1033 ","226424 ",100.00,"226424 ",100.00,111384,115030,10,226424
"Anaikattu","Tamil Nadu",2549,1780,0,4329,"1024 ","213356 ",100.00,"213356 ",100.00,105404,107951,1,213356
"Kilvaithinankuppam","Tamil Nadu",2647,1836,0,4483,"1005 ","192095 ",100.00,"192095 ",100.00,95812,96282,1,192095
"Gudiyattam","Tamil Nadu",3294,2319,0,5613,"1020 ","240792 ",100.00,"240792 ",100.00,119232,121560,0,240792
"Vaniyambadi","Tamil Nadu",3292,2266,0,5558,"989 ","209125 ",100.00,"209125 ",100.00,105137,103987,1,209125
"Ambur","Tamil Nadu",2690,1877,0,4567,"1024 ","198623 ",100.00,"198623 ",100.00,98123,100499,1,198623
"Jolarpet","Tamil Nadu",3396,2256,0,5652,"1000 ","215327 ",100.00,"215327 ",100.00,107690,107637,0,215327
"Tirupattur","Tamil Nadu",3318,2297,0,5615,"995 ","212255 ",100.00,"212255 ",100.00,106390,105855,10,212255
"Uthangarai","Tamil Nadu",3851,2679,6,6536,"971 ","206593 ",100.00,"206593 ",100.00,104818,101749,26,206593
"Bargur","Tamil Nadu",3637,2810,4,6451,"985 ","217094 ",100.00,"217094 ",100.00,109386,107698,10,217094
"Krishnagiri","Tamil Nadu",3920,2945,0,6865,"1014 ","231016 ",100.00,"231016 ",100.00,114675,116313,28,231016
"Veppanahalli","Tamil Nadu",3696,2384,0,6080,"940 ","215384 ",100.00,"215384 ",100.00,111012,104365,7,215384
"Hosur","Tamil Nadu",3563,2653,4,6220,"918 ","267906 ",100.00,"267906 ",100.00,139655,128212,39,267906
"Thalli","Tamil Nadu",2946,1964,0,4910,"922 ","214580 ",100.00,"214580 ",100.00,111617,102960,3,214580
"Palacode","Tamil Nadu",3712,2287,0,5999,"935 ","197063 ",100.00,"197063 ",100.00,101855,95207,1,197063
"Pennagaram","Tamil Nadu",4045,2300,0,6345,"920 ","210954 ",100.00,"210954 ",100.00,109883,101071,0,210954
"Dharmapuri","Tamil Nadu",4414,3049,0,7463,"961 ","233285 ",100.00,"233285 ",100.00,118956,114281,48,233285
"Pappireddippatti","Tamil Nadu",4109,2678,0,6787,"965 ","231915 ",100.00,"231915 ",100.00,118043,113871,1,231915
"Harur","Tamil Nadu",3333,2178,0,5511,"957 ","211528 ",100.00,"211528 ",100.00,108061,103465,2,211528
"Chengam","Tamil Nadu",3306,2215,0,5521,"989 ","232413 ",100.00,"232413 ",100.00,116843,115570,0,232413
"Tiruvannamalai","Tamil Nadu",3412,2753,1,6166,"1037 ","240016 ",100.00,"240016 ",100.00,117809,122195,12,240016
"Kilpennathur","Tamil Nadu",3289,2436,0,5725,"1010 ","225304 ",100.00,"225304 ",100.00,112109,113194,1,225304
"Kalasapakkam","Tamil Nadu",3334,2118,0,5452,"996 ","206409 ",100.00,"206409 ",100.00,103420,102989,0,206409
"Polur","Tamil Nadu",3635,2309,0,5944,"998 ","216334 ",100.00,"216334 ",100.00,108296,108038,0,216334
"Arani","Tamil Nadu",3890,2918,0,6808,"1034 ","239929 ",100.00,"239929 ",100.00,117970,121959,0,239929
"Cheyyar","Tamil Nadu",3976,3079,0,7055,"1010 ","232318 ",100.00,"232318 ",100.00,115601,116717,0,232318
"Vandavasi","Tamil Nadu",3272,2400,0,5672,"987 ","216422 ",100.00,"216422 ",100.00,108898,107524,0,216422
"Gingee","Tamil Nadu",3169,2779,2,5950,"1004 ","239471 ",100.00,"239471 ",100.00,119496,119955,20,239471
"Mailam","Tamil Nadu",3061,2241,0,5302,"980 ","203680 ",100.00,"203680 ",100.00,102876,100791,13,203680
"Tindivanam","Tamil Nadu",3035,2255,1,5291,"1013 ","212646 ",100.00,"212646 ",100.00,105647,106989,10,212646
"Vanur","Tamil Nadu",2919,2077,1,4997,"1013 ","214685 ",100.00,"214685 ",100.00,106626,108045,14,214685
"Villupuram","Tamil Nadu",3449,2694,0,6143,"1029 ","241942 ",100.00,"241942 ",100.00,119230,122677,35,241942
"Vikravandi","Tamil Nadu",3221,2346,1,5568,"993 ","211882 ",100.00,"211882 ",100.00,106311,105557,14,211882
"Tirukkoyilur","Tamil Nadu",3589,2614,1,6204,"964 ","225049 ",100.00,"225049 ",100.00,114605,110422,22,225049
"Ulundurpettai","Tamil Nadu",4626,3157,2,7785,"966 ","262131 ",100.00,"262131 ",100.00,133334,128771,26,262131
"Rishivandiyam","Tamil Nadu",3594,2373,8,5975,"946 ","233694 ",100.00,"233694 ",100.00,120052,113589,53,233694
"Sankarapuram","Tamil Nadu",3626,2669,7,6302,"982 ","236857 ",100.00,"236857 ",100.00,119492,117337,28,236857
"Kallakurichi","Tamil Nadu",4250,3202,3,7455,"978 ","251168 ",100.00,"251168 ",100.00,126964,124183,21,251168
"Gangavalli","Tamil Nadu",2762,2026,1,4789,"1026 ","207307 ",100.00,"207307 ",100.00,102319,104972,16,207307
"Attur","Tamil Nadu",2820,2162,0,4982,"1033 ","218237 ",100.00,"218237 ",100.00,107330,110901,6,218237
"Yercaud","Tamil Nadu",3835,2709,1,6545,"1011 ","242912 ",100.00,"242912 ",100.00,120764,122141,7,242912
"Omalur","Tamil Nadu",3601,2041,1,5643,"918 ","247249 ",100.00,"247249 ",100.00,128916,118317,16,247249
"Mettur","Tamil Nadu",3245,2076,0,5321,"945 ","245289 ",100.00,"245289 ",100.00,126077,119188,24,245289
"Edappadi","Tamil Nadu",3430,2109,1,5540,"943 ","247912 ",100.00,"247912 ",100.00,127558,120344,10,247912
"Sankari","Tamil Nadu",3298,2060,1,5359,"951 ","240126 ",100.00,"240126 ",100.00,123045,117050,31,240126
"Salem (West)","Tamil Nadu",3048,2126,2,5176,"973 ","249078 ",100.00,"249078 ",100.00,126229,122829,20,249078
"Salem (North)","Tamil Nadu",2894,2361,1,5256,"1014 ","248120 ",100.00,"248120 ",100.00,123167,124926,27,248120
"Salem (South)","Tamil Nadu",3389,2710,0,6099,"1010 ","249392 ",100.00,"249392 ",100.00,124039,125327,26,249392
"Veerapandi","Tamil Nadu",3497,2346,3,5846,"969 ","223893 ",100.00,"223893 ",100.00,113726,110155,12,223893
"Rasipuram","Tamil Nadu",2708,2007,0,4715,"1010 ","209227 ",100.00,"209227 ",100.00,104083,105143,1,209227
"Senthamangalam","Tamil Nadu",2566,1882,0,4448,"1017 ","220760 ",100.00,"220760 ",100.00,109450,111308,2,220760
"Namakkal","Tamil Nadu",2596,1886,0,4482,"1030 ","229513 ",100.00,"229513 ",100.00,113042,116451,20,229513
"Paramathi-Velur","Tamil Nadu",2430,1744,0,4174,"1041 ","199916 ",100.00,"199916 ",100.00,97949,101966,1,199916
"Tiruchengodu","Tamil Nadu",2605,1869,0,4474,"1019 ","205933 ",100.00,"205933 ",100.00,102008,103909,16,205933
"Kumarapalayam","Tamil Nadu",2458,1801,0,4259,"1008 ","216308 ",100.00,"216308 ",100.00,107735,108569,4,216308
"Erode (East)","Tamil Nadu",1794,1378,0,3172,"1010 ","199947 ",100.00,"199947 ",100.00,99493,100453,1,199947
"Erode (West)","Tamil Nadu",2192,1450,0,3642,"996 ","229679 ",100.00,"229679 ",100.00,115039,114612,28,229679
"Modakkurichi","Tamil Nadu",2026,1481,0,3507,"1036 ","210576 ",100.00,"210576 ",100.00,103418,107152,6,210576
"Dharapuram (SC)","Tamil Nadu",2334,1678,0,4012,"1009 ","226081 ",100.00,"226081 ",100.00,112512,113565,4,226081
"Kangayam","Tamil Nadu",2161,1574,0,3735,"1013 ","213823 ",100.00,"213823 ",100.00,106237,107573,13,213823
"Perundurai","Tamil Nadu",2407,1836,0,4243,"1011 ","198540 ",100.00,"198540 ",100.00,98726,99814,0,198540
"Bhavani","Tamil Nadu",2422,1740,3,4165,"983 ","217264 ",100.00,"217264 ",100.00,109549,107708,7,217264
"Anthiyur","Tamil Nadu",2046,1378,1,3425,"981 ","194491 ",100.00,"194491 ",100.00,98195,96292,4,194491
"Gobichettipalayam","Tamil Nadu",2435,1849,0,4284,"1016 ","232745 ",100.00,"232745 ",100.00,115430,117311,4,232745
"Bhavanisagar","Tamil Nadu",2434,1863,1,4298,"995 ","229259 ",100.00,"229259 ",100.00,114921,114332,6,229259
"Udhagamandalam","Tamil Nadu",1724,1326,0,3050,"1029 ","188808 ",100.00,"188808 ",100.00,93047,95761,0,188808
"Gudalur","Tamil Nadu",1944,1364,0,3308,"1008 ","167458 ",100.00,"167458 ",100.00,83403,84055,0,167458
"Coonoor","Tamil Nadu",1578,1252,0,2830,"1053 ","176863 ",100.00,"176863 ",100.00,86139,90724,0,176863
"Mettuppalayam","Tamil Nadu",2506,1861,0,4367,"1014 ","251649 ",100.00,"251649 ",100.00,124947,126696,6,251649
"Avanashi (SC)","Tamil Nadu",2284,1678,1,3963,"1003 ","227400 ",100.00,"227400 ",100.00,113500,113885,15,227400
"Tiruppur (North)","Tamil Nadu",2686,1836,1,4523,"920 ","279492 ",100.00,"279492 ",100.00,145575,133897,20,279492
"Tiruppur (South)","Tamil Nadu",2237,1587,0,3824,"934 ","216036 ",100.00,"216036 ",100.00,111705,104316,15,216036
"Palladam","Tamil Nadu",2449,1858,0,4307,"956 ","281643 ",100.00,"281643 ",100.00,143994,137642,7,281643
"Sulur","Tamil Nadu",2549,1891,0,4440,"1002 ","252759 ",100.00,"252759 ",100.00,126272,126487,0,252759
"Kavundampalayam","Tamil Nadu",3546,2833,0,6379,"979 ","362697 ",100.00,"362697 ",100.00,183298,179399,0,362697
"Coimbatore (North)","Tamil Nadu",2448,1982,0,4430,"973 ","268519 ",100.00,"268519 ",100.00,136088,132431,0,268519
"Thondamuthur","Tamil Nadu",2555,2027,0,4582,"989 ","263701 ",100.00,"263701 ",100.00,132578,131123,0,263701
"Coimbatore (South)","Tamil Nadu",1764,1488,1,3253,"991 ","221986 ",100.00,"221986 ",100.00,111486,110495,5,221986
"Singanallur","Tamil Nadu",2246,1840,0,4086,"978 ","265653 ",100.00,"265653 ",100.00,134312,131328,13,265653
"Kinathukadavu","Tamil Nadu",2808,2194,0,5002,"1004 ","260960 ",100.00,"260960 ",100.00,130194,130766,0,260960
"Pollachi","Tamil Nadu",2331,1965,0,4296,"1028 ","204223 ",100.00,"204223 ",100.00,100694,103528,1,204223
"Valparai","Tamil Nadu",2164,1563,0,3727,"1032 ","182905 ",100.00,"182905 ",100.00,90025,92879,1,182905
"Udumalaipettai","Tamil Nadu",2493,1904,2,4399,"1020 ","227755 ",100.00,"227755 ",100.00,112762,114987,6,227755
"Madathukulam","Tamil Nadu",2311,1742,2,4055,"1003 ","203192 ",100.00,"203192 ",100.00,101423,101764,5,203192
"Palani","Tamil Nadu",2617,1897,0,4514,"1000 ","238338 ",100.00,"238338 ",100.00,119145,119169,24,238338
"Oddanchatram","Tamil Nadu",2442,1744,2,4188,"1004 ","211581 ",100.00,"211581 ",100.00,105566,106011,4,211581
"Athoor","Tamil Nadu",3409,2528,0,5937,"1034 ","255505 ",100.00,"255505 ",100.00,125642,129853,10,255505
"Nilakkottai","Tamil Nadu",2795,2033,0,4828,"1000 ","202124 ",100.00,"202124 ",100.00,101045,101076,3,202124
"Natham","Tamil Nadu",3254,2446,4,5704,"1004 ","241217 ",100.00,"241217 ",100.00,120365,120820,32,241217
"Dindigul","Tamil Nadu",2765,2318,0,5083,"1027 ","225874 ",100.00,"225874 ",100.00,111429,114411,34,225874
"Vedasandur","Tamil Nadu",3177,2351,0,5528,"1007 ","236696 ",100.00,"236696 ",100.00,117909,118786,1,236696
"Aravakurichi","Tamil Nadu",2141,1694,0,3835,"1045 ","191134 ",100.00,"191134 ",100.00,93458,97676,0,191134
"Karur","Tamil Nadu",2861,2639,0,5500,"1078 ","220641 ",100.00,"220641 ",100.00,106185,114456,0,220641
"Krishnarayapuram","Tamil Nadu",2749,2077,0,4826,"1021 ","194096 ",100.00,"194096 ",100.00,96042,98029,25,194096
"Kulithalai","Tamil Nadu",2870,2014,0,4884,"1009 ","197494 ",100.00,"197494 ",100.00,98323,99170,1,197494
"Manapparai","Tamil Nadu",4066,3053,0,7119,"1005 ","250646 ",100.00,"250646 ",100.00,125038,125607,1,250646
"Srirangam","Tamil Nadu",3375,2597,0,5972,"1023 ","260437 ",100.00,"260437 ",100.00,128743,131681,13,260437
"Tiruchirappalli (West)","Tamil Nadu",2761,2296,0,5057,"1043 ","236589 ",100.00,"236589 ",100.00,115817,120767,5,236589
"Tiruchirappalli (East)","Tamil Nadu",2517,2262,0,4779,"1028 ","227323 ",100.00,"227323 ",100.00,112107,115193,23,227323
"Thiruverumbur","Tamil Nadu",2839,2249,1,5089,"998 ","249920 ",100.00,"249920 ",100.00,125079,124811,30,249920
"Lalgudi","Tamil Nadu",2377,1729,0,4106,"1026 ","191331 ",100.00,"191331 ",100.00,94449,96872,10,191331
"Manachanallur","Tamil Nadu",2726,2167,0,4893,"1027 ","208352 ",100.00,"208352 ",100.00,102802,105545,5,208352
"Musiri","Tamil Nadu",2824,2075,0,4899,"1019 ","206386 ",100.00,"206386 ",100.00,102215,104171,0,206386
"Thuraiyur","Tamil Nadu",2318,1806,0,4124,"1035 ","202204 ",100.00,"202204 ",100.00,99371,102833,0,202204
"Perambalur","Tamil Nadu",3488,2558,1,6047,"1035 ","256851 ",100.00,"256851 ",100.00,126225,130616,10,256851
"Kunnam","Tamil Nadu",3726,2624,2,6352,"1003 ","238302 ",100.00,"238302 ",100.00,118986,119301,15,238302
"Ariyalur","Tamil Nadu",3391,2163,0,5554,"997 ","233151 ",100.00,"233151 ",100.00,116748,116403,0,233151
"Jayankondam","Tamil Nadu",3752,2422,0,6174,"995 ","234435 ",100.00,"234435 ",100.00,117513,116922,0,234435
"Tittakudi (SC)","Tamil Nadu",3510,2668,0,6178,"992 ","194916 ",100.00,"194916 ",100.00,97844,97072,0,194916
"Vridhachalam","Tamil Nadu",3890,2426,0,6316,"967 ","216320 ",100.00,"216320 ",100.00,109997,106319,4,216320
"Neyveli","Tamil Nadu",3126,2165,3,5294,"964 ","187180 ",100.00,"187180 ",100.00,95300,91872,8,187180
"Panruti","Tamil Nadu",3137,2189,1,5327,"1011 ","212752 ",100.00,"212752 ",100.00,105769,106976,7,212752
"Cuddalore","Tamil Nadu",2999,2468,1,5468,"1033 ","209828 ",100.00,"209828 ",100.00,103212,106598,18,209828
"Kurinjipadi","Tamil Nadu",3407,2287,0,5694,"979 ","205957 ",100.00,"205957 ",100.00,104053,101903,1,205957
"Bhuvanagiri","Tamil Nadu",3357,2192,0,5549,"971 ","223779 ",100.00,"223779 ",100.00,113529,110250,0,223779
"Chidambaram","Tamil Nadu",3104,1870,0,4974,"1000 ","212138 ",100.00,"212138 ",100.00,106044,106093,1,212138
"Kattumannarkoil(SC)","Tamil Nadu",2885,1854,0,4739,"944 ","196879 ",100.00,"196879 ",100.00,101257,95619,3,196879
"Sirkazhi","Tamil Nadu",3347,2177,0,5524,"1002 ","218699 ",100.00,"218699 ",100.00,109226,109472,1,218699
"Mayiladuthurai","Tamil Nadu",2443,1730,0,4173,"981 ","213446 ",100.00,"213446 ",100.00,107756,105690,0,213446
"Poompuhar","Tamil Nadu",3178,2149,0,5327,"985 ","238048 ",100.00,"238048 ",100.00,119953,118095,0,238048
"Nagapattinam","Tamil Nadu",2578,1632,0,4210,"1022 ","169759 ",100.00,"169759 ",100.00,83954,85805,0,169759
"Kilvelur","Tamil Nadu",2466,1734,0,4200,"995 ","154656 ",100.00,"154656 ",100.00,77519,77137,0,154656
"Vedaranyam","Tamil Nadu",2367,1587,0,3954,"1016 ","172906 ",100.00,"172906 ",100.00,85767,87139,0,172906
"Thiruthuraipoondi","Tamil Nadu",2493,1788,0,4281,"994 ","211743 ",100.00,"211743 ",100.00,106186,105557,0,211743
"Mannargudi","Tamil Nadu",2673,2145,0,4818,"1005 ","226295 ",100.00,"226295 ",100.00,112865,113430,0,226295
"Thiruvarur","Tamil Nadu",3093,2023,0,5116,"999 ","236600 ",100.00,"236600 ",100.00,118377,118216,7,236600
"Nannilam","Tamil Nadu",3064,2003,0,5067,"957 ","243074 ",100.00,"243074 ",100.00,124216,118858,0,243074
"Thiruvidaimarudur","Tamil Nadu",2838,1727,0,4565,"957 ","215729 ",100.00,"215729 ",100.00,110225,105504,0,215729
"Kumbakonam","Tamil Nadu",2787,1993,0,4780,"994 ","221470 ",100.00,"221470 ",100.00,111057,110413,0,221470
"Papanasam","Tamil Nadu",2951,1902,0,4853,"990 ","216821 ",100.00,"216821 ",100.00,108949,107872,0,216821
"Thiruvaiyaru","Tamil Nadu",3079,2261,0,5340,"1007 ","230814 ",100.00,"230814 ",100.00,114997,115817,0,230814
"Thanjavur","Tamil Nadu",2489,1936,0,4425,"1043 ","241048 ",100.00,"241048 ",100.00,117970,123078,0,241048
"Orathanadu","Tamil Nadu",2636,1835,0,4471,"1001 ","211099 ",100.00,"211099 ",100.00,105480,105619,0,211099
"Pattukkottai","Tamil Nadu",2696,1758,0,4454,"1065 ","210470 ",100.00,"210470 ",100.00,101899,108562,9,210470
"Peravurani","Tamil Nadu",2311,1444,0,3755,"1005 ","190444 ",100.00,"190444 ",100.00,95001,95443,0,190444
"Gandharvakottai","Tamil Nadu",2308,1330,0,3638,"948 ","172055 ",100.00,"172055 ",100.00,88312,83740,3,172055
"Viralimalai","Tamil Nadu",2901,1852,0,4753,"979 ","185135 ",100.00,"185135 ",100.00,93555,91578,2,185135
"Pudukkottai","Tamil Nadu",3040,2344,0,5384,"1009 ","207177 ",100.00,"207177 ",100.00,103099,104072,6,207177
"Thirumayam","Tamil Nadu",2515,1717,0,4232,"1020 ","193921 ",100.00,"193921 ",100.00,96008,97913,0,193921
"Alangudi","Tamil Nadu",2046,1186,0,3232,"994 ","185725 ",100.00,"185725 ",100.00,93157,92568,0,185725
"Aranthangi","Tamil Nadu",2185,1377,0,3562,"984 ","191916 ",100.00,"191916 ",100.00,96716,95200,0,191916
"Karaikudi","Tamil Nadu",3260,2440,0,5700,"1006 ","263243 ",100.00,"263243 ",100.00,131206,132037,0,263243
"Tiruppattur","Tamil Nadu",3641,2567,0,6208,"1015 ","249579 ",100.00,"249579 ",100.00,123863,125716,0,249579
"Sivaganga","Tamil Nadu",3710,2520,0,6230,"1006 ","251767 ",100.00,"251767 ",100.00,125537,126230,0,251767
"Manamadurai","Tamil Nadu",3181,2356,0,5537,"994 ","238029 ",100.00,"238029 ",100.00,119369,118660,0,238029
"Melur","Tamil Nadu",3055,1985,0,5040,"1013 ","223165 ",100.00,"223165 ",100.00,110873,112292,0,223165
"Madurai East","Tamil Nadu",3746,2907,0,6653,"1008 ","261490 ",100.00,"261490 ",100.00,130221,131255,14,261490
"Sholavandan","Tamil Nadu",2661,1824,0,4485,"1013 ","197753 ",100.00,"197753 ",100.00,98217,99534,2,197753
"Madurai North","Tamil Nadu",2459,2074,0,4533,"1021 ","227598 ",100.00,"227598 ",100.00,112636,114948,14,227598
"Madurai South","Tamil Nadu",2360,1818,0,4178,"1005 ","206945 ",100.00,"206945 ",100.00,103194,103750,1,206945
"Madurai Central","Tamil Nadu",2374,1958,0,4332,"1020 ","222491 ",100.00,"222491 ",100.00,110167,112322,2,222491
"Madurai West","Tamil Nadu",2992,2353,0,5345,"989 ","260463 ",100.00,"260463 ",100.00,130945,129506,12,260463
"Thiruparankundram","Tamil Nadu",2984,2290,0,5274,"994 ","256535 ",100.00,"256535 ",100.00,128644,127880,11,256535
"Thirumangalam","Tamil Nadu",4182,3188,0,7370,"1033 ","248929 ",100.00,"248929 ",100.00,122457,126467,5,248929
"Usilampatti","Tamil Nadu",3785,2437,0,6222,"988 ","255658 ",100.00,"255658 ",100.00,128601,127052,5,255658
"Andipatti","Tamil Nadu",2865,1850,0,4715,"995 ","234502 ",100.00,"234502 ",100.00,117516,116976,10,234502
"Periyakulam","Tamil Nadu",2728,2003,0,4731,"1010 ","231184 ",100.00,"231184 ",100.00,114990,116147,47,231184
"Bodinayakanur","Tamil Nadu",2850,2101,0,4951,"1002 ","238062 ",100.00,"238062 ",100.00,118889,119166,7,238062
"Cumbum","Tamil Nadu",2366,1696,0,4062,"1020 ","240964 ",100.00,"240964 ",100.00,119274,121674,16,240964
"Rajapalayam","Tamil Nadu",2374,1776,1,4151,"1023 ","208755 ",100.00,"208755 ",100.00,103196,105545,14,208755
"Srivilliputhur","Tamil Nadu",2285,1761,0,4046,"1013 ","211667 ",100.00,"211667 ",100.00,105120,106535,12,211667
"Sattur","Tamil Nadu",2856,2076,0,4932,"1026 ","207083 ",100.00,"207083 ",100.00,102189,104882,12,207083
"Sivakasi","Tamil Nadu",2847,2205,1,5053,"1022 ","214554 ",100.00,"214554 ",100.00,106102,108435,17,214554
"Virudhunagar","Tamil Nadu",2389,1839,1,4229,"1011 ","193579 ",100.00,"193579 ",100.00,96247,97300,32,193579
"Aruppukkottai","Tamil Nadu",2646,1975,2,4623,"1029 ","192355 ",100.00,"192355 ",100.00,94804,97541,10,192355
"Tiruchuli","Tamil Nadu",2864,2100,0,4964,"1017 ","195367 ",100.00,"195367 ",100.00,96854,98508,5,195367
"Paramakudi","Tamil Nadu",3146,2261,0,5407,"999 ","231935 ",100.00,"231935 ",100.00,116039,115875,21,231935
"Tiruvadanai","Tamil Nadu",3470,2379,1,5850,"974 ","251541 ",100.00,"251541 ",100.00,127386,124130,25,251541
"Ramanathapuram","Tamil Nadu",3721,2626,0,6347,"993 ","263317 ",100.00,"263317 ",100.00,132124,131183,10,263317
"Mudhukulathur","Tamil Nadu",3884,2667,0,6551,"982 ","283504 ",100.00,"283504 ",100.00,143005,140494,5,283504
"Vilathikulam","Tamil Nadu",2680,2071,0,4751,"1007 ","196950 ",100.00,"196950 ",100.00,98117,98833,0,196950
"Thoothukkudi","Tamil Nadu",3307,2820,0,6127,"1008 ","250213 ",100.00,"250213 ",100.00,124593,125620,0,250213
"Tiruchendur","Tamil Nadu",3213,2667,0,5880,"1039 ","212277 ",100.00,"212277 ",100.00,104117,108160,0,212277
"Srivaikuntam","Tamil Nadu",3051,2373,0,5424,"1014 ","195641 ",100.00,"195641 ",100.00,97124,98517,0,195641
"Ottapidaram","Tamil Nadu",2705,1981,0,4686,"1001 ","199702 ",100.00,"199702 ",100.00,99784,99918,0,199702
"Kovilpatti","Tamil Nadu",2608,1997,0,4605,"1006 ","221845 ",100.00,"221845 ",100.00,110574,111270,1,221845
"Sankarankovil","Tamil Nadu",2907,2358,0,5265,"1022 ","220548 ",100.00,"220548 ",100.00,109051,111497,0,220548
"Vasudevanallur","Tamil Nadu",2751,1981,0,4732,"996 ","211534 ",100.00,"211534 ",100.00,105984,105550,0,211534
"Kadayanallur","Tamil Nadu",3089,2172,0,5261,"982 ","250965 ",100.00,"250965 ",100.00,126624,124340,1,250965
"Tenkasi","Tamil Nadu",3249,2574,0,5823,"1000 ","246310 ",100.00,"246310 ",100.00,123161,123148,1,246310
"Alangulam","Tamil Nadu",3185,2418,0,5603,"1031 ","230253 ",100.00,"230253 ",100.00,113381,116872,0,230253
"Tirunelveli","Tamil Nadu",2897,2245,0,5142,"1011 ","245925 ",100.00,"245925 ",100.00,122271,123646,8,245925
"Ambasamudram","Tamil Nadu",2470,1853,0,4323,"1025 ","219839 ",100.00,"219839 ",100.00,108550,111289,0,219839
"Palayamkottai","Tamil Nadu",2533,1920,0,4453,"1013 ","233974 ",100.00,"233974 ",100.00,116210,117762,2,233974
"Nanguneri","Tamil Nadu",2890,1879,0,4769,"997 ","226937 ",100.00,"226937 ",100.00,113651,113286,0,226937
"Radhapuram","Tamil Nadu",3587,2701,0,6288,"993 ","227284 ",100.00,"227284 ",100.00,114061,113223,0,227284
"Kanniyakumari","Tamil Nadu",3526,2690,0,6216,"978 ","262766 ",100.00,"262766 ",100.00,132806,129950,10,262766
"Nagercoil","Tamil Nadu",2660,2202,0,4862,"1001 ","242230 ",100.00,"242230 ",100.00,121045,121179,6,242230
"Colachel","Tamil Nadu",3265,2366,1,5632,"943 ","241312 ",100.00,"241312 ",100.00,124214,117092,6,241312
"Padmanabhapuram","Tamil Nadu",2643,2208,1,4852,"950 ","216138 ",100.00,"216138 ",100.00,110811,105316,11,216138
"Vilavancode","Tamil Nadu",2819,2219,0,5038,"1007 ","231650 ",100.00,"231650 ",100.00,115438,116195,17,231650
"Killiyoor","Tamil Nadu",3066,2303,2,5371,"971 ","236822 ",100.00,"236822 ",100.00,120124,116684,14,236822
"Simna","Tripura",828,746,0,1574,"992 ","33330 ",100.00,"33330 ",100.00,16733,16597,0,33330
"Mohanpur","Tripura",1226,907,0,2133,"966 ","40924 ",100.00,"40924 ",100.00,20811,20113,0,40924
"Bamutia","Tripura",1142,912,0,2054,"972 ","39426 ",100.00,"39426 ",100.00,19995,19431,0,39426
"Barjala","Tripura",1017,703,0,1720,"946 ","38353 ",100.00,"38353 ",100.00,19710,18643,0,38353
"Khayerpur","Tripura",1205,972,0,2177,"953 ","43940 ",100.00,"43940 ",100.00,22501,21439,0,43940
"Agartala","Tripura",1100,916,0,2016,"1012 ","46257 ",100.00,"46257 ",100.00,22992,23265,0,46257
"Ramnagar","Tripura",957,795,0,1752,"1041 ","41104 ",100.00,"41104 ",100.00,20139,20965,0,41104
"Town Bordowali","Tripura",911,786,0,1697,"1050 ","45037 ",100.00,"45037 ",100.00,21965,23072,0,45037
"Banamalipur","Tripura",708,622,0,1330,"1043 ","39505 ",100.00,"39505 ",100.00,19337,20168,0,39505
"Majlishpur","Tripura",1180,998,0,2178,"977 ","42644 ",100.00,"42644 ",100.00,21570,21074,0,42644
"Mandaibazar","Tripura",1074,1004,0,2078,"987 ","41408 ",100.00,"41408 ",100.00,20843,20565,0,41408
"Takarjala","Tripura",1038,773,0,1811,"982 ","37926 ",100.00,"37926 ",100.00,19137,18789,0,37926
"Pratapgarh","Tripura",1306,985,0,2291,"957 ","49154 ",100.00,"49154 ",100.00,25121,24033,0,49154
"Badharghat","Tripura",1430,1104,0,2534,"953 ","53126 ",100.00,"53126 ",100.00,27199,25927,0,53126
"Kamalasagar","Tripura",1039,634,0,1673,"928 ","37863 ",100.00,"37863 ",100.00,19639,18224,0,37863
"Bishalgarh","Tripura",1336,904,0,2240,"944 ","43717 ",100.00,"43717 ",100.00,22494,21223,0,43717
"Golaghati","Tripura",1079,657,0,1736,"933 ","36910 ",100.00,"36910 ",100.00,19096,17814,0,36910
"Suryamaninagar","Tripura",1246,913,0,2159,"949 ","45316 ",100.00,"45316 ",100.00,23246,22070,0,45316
"Charilam","Tripura",956,692,0,1648,"958 ","34990 ",100.00,"34990 ",100.00,17870,17120,0,34990
"Boxanagar","Tripura",1522,785,0,2307,"958 ","34055 ",100.00,"34055 ",100.00,17395,16660,0,34055
"Nalchar","Tripura",1358,862,0,2220,"918 ","38707 ",100.00,"38707 ",100.00,20182,18525,0,38707
"Sonamura","Tripura",1360,746,0,2106,"929 ","36616 ",100.00,"36616 ",100.00,18977,17639,0,36616
"Dhanpur","Tripura",1564,859,0,2423,"910 ","39560 ",100.00,"39560 ",100.00,20717,18843,0,39560
"Ramchandraghat","Tripura",891,645,0,1536,"971 ","35740 ",100.00,"35740 ",100.00,18129,17611,0,35740
"Khowai","Tripura",1135,941,0,2076,"973 ","38937 ",100.00,"38937 ",100.00,19733,19204,0,38937
"Asharambari","Tripura",880,680,0,1560,"963 ","32797 ",100.00,"32797 ",100.00,16707,16090,0,32797
"Kalyanpur-Pramodenagar","Tripura",1020,777,0,1797,"967 ","39356 ",100.00,"39356 ",100.00,20011,19345,0,39356
"Teliamura","Tripura",981,808,0,1789,"977 ","39441 ",100.00,"39441 ",100.00,19950,19491,0,39441
"Krishnapur","Tripura",841,596,0,1437,"940 ","31710 ",100.00,"31710 ",100.00,16345,15365,0,31710
"Bagma","Tripura",1213,1018,0,2231,"992 ","47005 ",100.00,"47005 ",100.00,23601,23404,0,47005
"Radhakishorepur","Tripura",1021,837,0,1858,"963 ","42590 ",100.00,"42590 ",100.00,21696,20894,0,42590
"Matarbari","Tripura",1306,882,0,2188,"949 ","46648 ",100.00,"46648 ",100.00,23938,22710,0,46648
"Kakraban-Salgarh","Tripura",1278,807,0,2085,"939 ","46503 ",100.00,"46503 ",100.00,23984,22519,0,46503
"Rajnagar","Tripura",1535,1022,0,2557,"895 ","40246 ",100.00,"40246 ",100.00,21242,19004,0,40246
"Belonia","Tripura",1113,936,0,2049,"948 ","38935 ",100.00,"38935 ",100.00,19988,18947,0,38935
"Santirbazar","Tripura",1362,1071,0,2433,"974 ","42143 ",100.00,"42143 ",100.00,21349,20794,0,42143
"Hrishyamukh","Tripura",1215,953,0,2168,"932 ","40308 ",100.00,"40308 ",100.00,20861,19447,0,40308
"Jolaibari","Tripura",1368,1053,0,2421,"949 ","41656 ",100.00,"41656 ",100.00,21370,20286,0,41656
"Manu","Tripura",1304,947,0,2251,"949 ","38798 ",100.00,"38798 ",100.00,19902,18896,0,38798
"Sabroom","Tripura",1467,1046,0,2513,"945 ","40630 ",100.00,"40630 ",100.00,20891,19739,0,40630
"Ampinagar","Tripura",929,711,0,1640,"1015 ","33552 ",100.00,"33552 ",100.00,16648,16904,0,33552
"Amarpur","Tripura",1386,1022,0,2408,"963 ","37276 ",100.00,"37276 ",100.00,18991,18285,0,37276
"Karbook","Tripura",901,607,0,1508,"969 ","31220 ",100.00,"31220 ",100.00,15859,15361,0,31220
"Raima Valley","Tripura",913,649,0,1562,"962 ","39226 ",100.00,"39226 ",100.00,19990,19236,0,39226
"Kamalpur","Tripura",1047,858,0,1905,"975 ","40671 ",100.00,"40671 ",100.00,20594,20077,0,40671
"Surma","Tripura",1149,923,0,2072,"951 ","41273 ",100.00,"41273 ",100.00,21154,20119,0,41273
"Ambassa","Tripura",1140,950,0,2090,"989 ","41852 ",100.00,"41852 ",100.00,21045,20807,0,41852
"Karmachara","Tripura",984,708,0,1692,"967 ","34458 ",100.00,"34458 ",100.00,17522,16936,0,34458
"Chawamanu","Tripura",920,748,0,1668,"971 ","35191 ",100.00,"35191 ",100.00,17855,17336,0,35191
"Pabiachhara","Tripura",1226,969,0,2195,"975 ","40702 ",100.00,"40702 ",100.00,20606,20096,0,40702
"Fatikroy","Tripura",1096,753,0,1849,"946 ","38178 ",100.00,"38178 ",100.00,19616,18562,0,38178
"Chandipur","Tripura",1103,709,0,1812,"954 ","39566 ",100.00,"39566 ",100.00,20248,19318,0,39566
"Kailashahar","Tripura",1283,911,0,2194,"968 ","42271 ",100.00,"42271 ",100.00,21477,20794,0,42271
"Kadamtala-Kurti","Tripura",1355,1273,0,2628,"957 ","37985 ",100.00,"37985 ",100.00,19408,18577,0,37985
"Bagbassa","Tripura",1321,1072,0,2393,"947 ","39159 ",100.00,"39159 ",100.00,20108,19051,0,39159
"Dharmanagar","Tripura",1116,902,0,2018,"981 ","38715 ",100.00,"38715 ",100.00,19540,19175,0,38715
"Jubarajnagar","Tripura",1373,1106,0,2479,"935 ","37438 ",100.00,"37438 ",100.00,19348,18090,0,37438
"Panisagar","Tripura",1069,839,0,1908,"932 ","32744 ",100.00,"32744 ",100.00,16952,15792,0,32744
"Pencharthal","Tripura",1152,958,0,2110,"961 ","36268 ",100.00,"36268 ",100.00,18491,17777,0,36268
"Kanchanpur","Tripura",1210,967,0,2177,"954 ","38485 ",100.00,"38485 ",100.00,19691,18794,0,38485
"Behat","Uttar Pradesh",5757,3535,0,9292,"850 ","314898 ",99.00,"315010 ",100.00,170236,144771,3,315010
"Nakur","Uttar Pradesh",6165,3784,0,9949,"863 ","308855 ",99.00,"309162 ",100.00,165975,143183,4,309162
"Saharanpur Nagar","Uttar Pradesh",5567,3549,0,9116,"838 ","377337 ",99.00,"377363 ",100.00,205290,172039,34,377363
"Saharanpur","Uttar Pradesh",5638,3021,2,8661,"822 ","292624 ",100.00,"292636 ",100.00,160621,132006,9,292636
"Deoband","Uttar Pradesh",7030,4221,3,11254,"831 ","312097 ",99.00,"312165 ",100.00,170438,141717,10,312165
"Rampur Maniharan","Uttar Pradesh",5992,3789,0,9781,"831 ","281286 ",99.00,"281433 ",100.00,153723,127706,5,281434
"Gangoh","Uttar Pradesh",5646,3084,0,8730,"822 ","331053 ",100.00,"331053 ",100.00,181652,149398,3,331053
"Kairana","Uttar Pradesh",4991,2403,2,7396,"803 ","273707 ",100.00,"273708 ",100.00,151807,121899,9,273715
"Thana Bhawan","Uttar Pradesh",5080,2110,3,7193,"796 ","294212 ",100.00,"294218 ",100.00,163803,130386,29,294218
"Shamli","Uttar Pradesh",4279,1998,2,6279,"788 ","285576 ",99.00,"285794 ",100.00,159826,125963,5,285794
"Budhana","Uttar Pradesh",5898,2933,0,8831,"804 ","340587 ",99.00,"340691 ",100.00,188853,151837,1,340691
"Charthawal","Uttar Pradesh",5076,1961,1,7038,"790 ","295142 ",99.00,"295559 ",100.00,165072,130481,6,295559
"Purqazi","Uttar Pradesh",4462,1658,0,6120,"790 ","289884 ",99.00,"290105 ",100.00,162075,128012,18,290105
"Muzaffar Nagar","Uttar Pradesh",3579,1680,0,5259,"825 ","309856 ",99.00,"310304 ",100.00,170017,140264,23,310304
"Khatauli","Uttar Pradesh",6391,3535,0,9926,"834 ","283139 ",99.00,"283456 ",100.00,154562,128882,12,283456
"Meerapur","Uttar Pradesh",4725,2257,0,6982,"827 ","274667 ",99.00,"274940 ",100.00,150449,124476,15,274940
"Najibabad","Uttar Pradesh",6574,7106,8,13688,"894 ","320358 ",99.00,"320425 ",100.00,169139,151261,25,320425
"Nagina","Uttar Pradesh",7248,7100,0,14348,"886 ","318476 ",99.00,"318647 ",100.00,168941,149677,29,318647
"Barhapur","Uttar Pradesh",6569,5084,1,11654,"860 ","324174 ",99.00,"324599 ",100.00,174513,150074,12,324599
"Dhampur","Uttar Pradesh",5675,4029,1,9705,"854 ","269728 ",100.00,"269728 ",100.00,145454,124269,5,269728
"Nehtaur","Uttar Pradesh",6393,5328,8,11729,"869 ","274470 ",99.00,"274497 ",100.00,146889,127582,26,274497
"Bijnor","Uttar Pradesh",7883,9455,2,17340,"905 ","348570 ",100.00,"348585 ",100.00,182992,165581,12,348585
"Chandpur","Uttar Pradesh",6567,5070,3,11640,"866 ","299202 ",100.00,"299208 ",100.00,160352,138846,10,299208
"Noorpur","Uttar Pradesh",7204,5408,3,12615,"852 ","289499 ",99.00,"289675 ",100.00,156421,133245,9,289675
"Kanth","Uttar Pradesh",7946,6279,3,14228,"840 ","328038 ",99.00,"328059 ",100.00,178331,149717,11,328059
"Thakurdwara","Uttar Pradesh",5974,4949,0,10923,"854 ","325040 ",99.00,"325764 ",100.00,175684,150069,11,325764
"Moradabad Rural","Uttar Pradesh",6187,3906,0,10093,"821 ","322861 ",99.00,"322912 ",100.00,177299,145600,13,322912
"Moradabad Nagar","Uttar Pradesh",6633,4141,1,10775,"826 ","419212 ",99.00,"419255 ",100.00,229613,189610,32,419255
"Kundarki","Uttar Pradesh",8363,5693,1,14057,"803 ","332727 ",100.00,"332736 ",100.00,184580,148141,15,332736
"Bilari","Uttar Pradesh",9227,6801,1,16029,"818 ","321913 ",99.00,"321991 ",100.00,177138,144846,7,321991
"Chandausi","Uttar Pradesh",7481,4683,3,12167,"812 ","337490 ",99.00,"338835 ",100.00,186950,151856,29,338835
"Asmoli","Uttar Pradesh",12527,8111,4,20642,"809 ","333382 ",99.00,"333407 ",100.00,184283,149101,23,333407
"Sambhal","Uttar Pradesh",10416,7724,5,18145,"822 ","334431 ",100.00,"334444 ",100.00,183566,150849,29,334444
"Suar","Uttar Pradesh",8038,6004,22,14064,"854 ","287008 ",99.00,"287057 ",100.00,154704,132124,229,287057
"Chamraua","Uttar Pradesh",8458,5425,5,13888,"845 ","286003 ",99.00,"286047 ",100.00,155025,130959,63,286047
"Bilaspur","Uttar Pradesh",8161,5273,1,13435,"849 ","314752 ",99.00,"314768 ",100.00,170268,144474,26,314768
"Rampur","Uttar Pradesh",7013,4569,0,11582,"846 ","365328 ",99.00,"365356 ",100.00,197939,167395,22,365356
"Milak","Uttar Pradesh",7652,5183,3,12838,"842 ","325678 ",99.00,"325723 ",100.00,176813,148891,19,325723
"Dhanaura","Uttar Pradesh",6090,3812,2,9904,"852 ","309868 ",100.00,"309876 ",100.00,167277,142579,20,309876
"Naugawan Sadat","Uttar Pradesh",6887,4924,1,11812,"876 ","292413 ",99.00,"292682 ",100.00,155964,136696,22,292682
"Amroha","Uttar Pradesh",4779,3262,0,8041,"869 ","277105 ",99.00,"277322 ",100.00,148338,128975,9,277322
"Hasanpur","Uttar Pradesh",8759,6084,1,14844,"871 ","326179 ",99.00,"326208 ",100.00,174352,151839,17,326208
"Siwalkhas","Uttar Pradesh",5959,2573,0,8532,"777 ","303800 ",100.00,"303802 ",100.00,170945,132846,11,303802
"Sardhana","Uttar Pradesh",6704,3091,6,9801,"816 ","319756 ",99.00,"319836 ",100.00,176120,143690,26,319836
"Hastinapur","Uttar Pradesh",5907,2999,0,8906,"798 ","320453 ",100.00,"320460 ",100.00,178181,142264,15,320460
"Kithore","Uttar Pradesh",5314,2694,0,8008,"787 ","322854 ",99.00,"322905 ",100.00,180650,142243,12,322905
"Meerut Cantt.","Uttar Pradesh",3944,2233,0,6177,"839 ","381764 ",100.00,"381767 ",100.00,207529,174195,43,381767
"Meerut","Uttar Pradesh",3190,1922,0,5112,"827 ","295648 ",99.00,"295680 ",100.00,161792,133870,18,295680
"Meerut South","Uttar Pradesh",6148,3211,0,9359,"807 ","400505 ",100.00,"400509 ",100.00,221571,178917,21,400509
"Chhaprauli","Uttar Pradesh",6304,3479,2,9785,"735 ","303120 ",99.00,"303344 ",100.00,174816,128512,16,303344
"Baraut","Uttar Pradesh",4038,1845,1,5884,"744 ","265078 ",99.00,"265490 ",100.00,152251,113226,13,265490
"Baghpat","Uttar Pradesh",4464,1642,1,6107,"759 ","267267 ",96.00,"277775 ",100.00,157926,119839,15,277780
"Loni","Uttar Pradesh",4106,1601,0,5707,"744 ","398776 ",100.00,"398783 ",100.00,228665,170103,15,398783
"Muradnagar","Uttar Pradesh",5423,2738,3,8164,"821 ","384204 ",99.00,"384228 ",100.00,211041,173177,10,384228
"Sahibabad","Uttar Pradesh",6939,3441,0,10380,"726 ","761310 ",100.00,"761324 ",100.00,441037,320283,4,761324
"Ghaziabad","Uttar Pradesh",4127,2302,1,6430,"778 ","374287 ",100.00,"374288 ",100.00,210553,163738,6,374297
"Modi Nagar","Uttar Pradesh",5955,3276,3,9234,"819 ","313474 ",100.00,"313486 ",100.00,172307,141155,24,313486
"Dholana","Uttar Pradesh",8763,6209,3,14975,"814 ","345257 ",99.00,"345329 ",100.00,190373,154948,8,345329
"Hapur","Uttar Pradesh",5447,3110,0,8557,"802 ","319737 ",99.00,"320214 ",100.00,177668,142533,13,320214
"Garhmukteshwar","Uttar Pradesh",7154,5165,2,12321,"821 ","312375 ",99.00,"312461 ",100.00,171614,140825,22,312461
"Noida","Uttar Pradesh",6069,3142,2,9213,"720 ","502781 ",99.00,"503075 ",100.00,292489,210569,16,503074
"Dadri","Uttar Pradesh",7338,3160,0,10498,"771 ","397151 ",99.00,"397772 ",100.00,224536,173215,21,397772
"Jewar","Uttar Pradesh",5979,2856,2,8837,"787 ","312211 ",99.00,"312316 ",100.00,174788,137521,7,312316
"Sikandrabad","Uttar Pradesh",6281,6501,1,12783,"878 ","367177 ",99.00,"367401 ",100.00,195647,171733,21,367401
"Bulandshahr","Uttar Pradesh",5907,4557,0,10464,"859 ","360882 ",100.00,"360892 ",100.00,194124,166752,15,360891
"Syana","Uttar Pradesh",5726,5384,1,11111,"860 ","363274 ",99.00,"363329 ",100.00,195294,168026,9,363329
"Anupshahr","Uttar Pradesh",4325,3188,7,7520,"840 ","342833 ",99.00,"342985 ",100.00,186344,156594,54,342992
"Debai","Uttar Pradesh",5980,5693,1,11674,"866 ","320123 ",100.00,"320125 ",100.00,171561,148549,15,320125
"Shikarpur","Uttar Pradesh",5745,5957,0,11702,"889 ","309565 ",99.00,"309620 ",100.00,163861,145752,7,309620
"Khurja","Uttar Pradesh",6212,6623,0,12835,"870 ","356137 ",100.00,"356143 ",100.00,190412,165722,9,356143
"Khair","Uttar Pradesh",10975,10200,3,21178,"851 ","362171 ",100.00,"362173 ",100.00,195652,166497,24,362173
"Barauli","Uttar Pradesh",8669,11423,0,20092,"876 ","341653 ",99.00,"341748 ",100.00,182159,159552,37,341748
"Atrauli","Uttar Pradesh",8345,11374,1,19720,"839 ","362495 ",99.00,"362554 ",100.00,197138,165403,13,362554
"Chharra","Uttar Pradesh",6772,9082,4,15858,"857 ","335381 ",100.00,"335381 ",100.00,180636,154732,13,335381
"Koil","Uttar Pradesh",5724,5607,3,11334,"869 ","343014 ",100.00,"343014 ",100.00,183483,159517,14,343014
"Aligarh","Uttar Pradesh",5028,4782,0,9810,"860 ","340452 ",100.00,"340452 ",100.00,182998,157440,14,340452
"Iglas","Uttar Pradesh",9712,10510,2,20224,"853 ","344027 ",100.00,"344027 ",100.00,185700,158317,10,344027
"Hathras","Uttar Pradesh",6309,4534,1,10844,"809 ","368153 ",99.00,"368240 ",100.00,203520,164715,5,368240
"Sadabad","Uttar Pradesh",5862,2366,0,8228,"741 ","330065 ",99.00,"330226 ",100.00,189703,140519,4,330226
"Sikandra Rao","Uttar Pradesh",6182,3934,1,10117,"804 ","334820 ",99.00,"335024 ",99.00,185673,149372,3,335048
"Chhata","Uttar Pradesh",5532,3115,4,8651,"790 ","315492 ",99.00,"315582 ",100.00,176269,139303,10,315582
"Mant","Uttar Pradesh",5685,2809,1,8495,"816 ","297725 ",99.00,"297953 ",100.00,164052,133870,31,297953
"Goverdhan","Uttar Pradesh",6654,4231,0,10885,"820 ","290920 ",99.00,"290990 ",100.00,159852,131123,15,290990
"Mathura","Uttar Pradesh",5438,2796,5,8239,"799 ","394127 ",99.00,"394176 ",100.00,219043,175057,76,394176
"Baldev","Uttar Pradesh",6664,3560,1,10225,"797 ","326048 ",99.00,"326399 ",100.00,181585,144805,9,326399
"Etmadpur","Uttar Pradesh",7005,3665,0,10670,"773 ","383009 ",99.00,"383542 ",100.00,216326,167211,5,383542
"Agra Cantt.","Uttar Pradesh",5252,3602,1,8855,"800 ","391857 ",99.00,"391946 ",100.00,217700,174232,14,391946
"Agra South","Uttar Pradesh",4172,2758,1,6931,"801 ","335048 ",99.00,"335127 ",100.00,186074,149040,13,335127
"Agra North","Uttar Pradesh",4153,2568,0,6721,"813 ","378198 ",99.00,"378353 ",100.00,208636,169698,19,378353
"Agra Rural","Uttar Pradesh",6550,3596,1,10147,"775 ","358692 ",99.00,"358980 ",100.00,202282,156684,16,358982
"Fatehpur Sikri","Uttar Pradesh",8700,7579,0,16279,"827 ","318407 ",99.00,"318548 ",100.00,174346,144202,0,318548
"Kheragarh","Uttar Pradesh",3696,2513,0,6209,"801 ","294890 ",99.00,"294913 ",100.00,163768,131134,11,294913
"Fatehabad","Uttar Pradesh",5321,5715,0,11036,"815 ","277606 ",100.00,"277610 ",100.00,152910,124695,5,277610
"Bah","Uttar Pradesh",3724,1925,3,5652,"787 ","303418 ",99.00,"303683 ",100.00,169930,133744,9,303683
"Tundla","Uttar Pradesh",4128,2500,1,6629,"820 ","328293 ",100.00,"328293 ",100.00,180355,147923,15,328293
"Jasrana","Uttar Pradesh",4506,2713,4,7223,"811 ","314801 ",99.00,"314858 ",100.00,173854,140986,18,314858
"Firozabad","Uttar Pradesh",3586,2658,0,6244,"806 ","360779 ",100.00,"360782 ",100.00,199738,161025,20,360783
"Shikohabad","Uttar Pradesh",4553,2625,0,7178,"813 ","313280 ",100.00,"313285 ",100.00,172810,140466,9,313285
"Sirsaganj","Uttar Pradesh",3575,2346,0,5921,"810 ","291809 ",100.00,"291813 ",100.00,161190,130618,5,291813
"Kasganj","Uttar Pradesh",5820,4072,1,9893,"838 ","337343 ",99.00,"337360 ",100.00,183523,153833,4,337360
"Amanpur","Uttar Pradesh",5852,4849,1,10702,"835 ","286398 ",99.00,"286533 ",100.00,156147,130374,12,286533
"Patiyali","Uttar Pradesh",4379,5145,0,9524,"833 ","319943 ",99.00,"320103 ",100.00,174667,145432,5,320104
"Aliganj","Uttar Pradesh",4676,3668,1,8345,"799 ","318661 ",99.00,"318802 ",100.00,177201,141596,5,318802
"Etah","Uttar Pradesh",6385,5907,0,12292,"836 ","309381 ",99.00,"309657 ",100.00,168619,141030,8,309657
"Marhara","Uttar Pradesh",6613,6548,1,13162,"851 ","288293 ",99.00,"288378 ",100.00,155832,132543,3,288378
"Jalesar","Uttar Pradesh",4662,5502,2,10166,"852 ","271980 ",99.00,"272086 ",100.00,146876,125200,10,272086
"Mainpuri","Uttar Pradesh",5221,4043,0,9264,"841 ","307393 ",99.00,"307527 ",100.00,167005,140519,3,307527
"Bhongaon","Uttar Pradesh",5657,6836,1,12494,"866 ","319082 ",99.00,"319109 ",100.00,170971,148131,7,319109
"Kishani","Uttar Pradesh",5434,6763,1,12198,"848 ","287970 ",99.00,"288035 ",100.00,155821,132211,3,288035
"Karhal","Uttar Pradesh",7107,6620,2,13729,"828 ","342592 ",99.00,"342673 ",100.00,187504,155163,6,342673
"Gunnaur","Uttar Pradesh",6785,3480,0,10265,"789 ","355120 ",99.00,"355543 ",100.00,198691,156831,21,355543
"Bisauli","Uttar Pradesh",8864,6894,0,15758,"809 ","365953 ",99.00,"366060 ",100.00,202392,163658,10,366060
"Sahaswan","Uttar Pradesh",7337,5490,1,12828,"819 ","370128 ",99.00,"370381 ",100.00,203650,166723,8,370381
"Bilsi","Uttar Pradesh",7301,4698,0,11999,"801 ","313073 ",99.00,"313425 ",100.00,173991,139431,3,313425
"Badaun","Uttar Pradesh",7203,5231,1,12435,"823 ","336558 ",99.00,"336591 ",100.00,184629,151948,14,336591
"Shekhupur","Uttar Pradesh",7265,4713,2,11980,"799 ","352823 ",99.00,"353016 ",100.00,196175,156839,2,353016
"Dataganj","Uttar Pradesh",6513,5315,0,11828,"791 ","357373 ",99.00,"357638 ",100.00,199680,157953,5,357638
"Baheri","Uttar Pradesh",8105,4689,0,12794,"818 ","319575 ",99.00,"319861 ",100.00,175966,143894,1,319861
"Meerganj","Uttar Pradesh",9297,8665,0,17962,"848 ","309303 ",99.00,"309364 ",100.00,167378,141978,8,309364
"Bhojipura","Uttar Pradesh",7822,4511,1,12334,"814 ","317705 ",99.00,"318171 ",100.00,175386,142778,7,318171
"Nawabganj","Uttar Pradesh",10640,7804,3,18447,"842 ","296380 ",100.00,"296385 ",100.00,160873,135502,10,296385
"Faridpur","Uttar Pradesh",7625,6637,2,14264,"816 ","293825 ",100.00,"293838 ",100.00,161774,132048,15,293837
"Bithari Chainpur","Uttar Pradesh",5804,3015,1,8820,"782 ","329496 ",99.00,"329775 ",100.00,185057,144713,5,329775
"Bareilly","Uttar Pradesh",3467,1831,0,5298,"804 ","369715 ",99.00,"370589 ",100.00,205476,165106,7,370589
"Bareilly Cantt.","Uttar Pradesh",2686,1699,0,4385,"815 ","309364 ",99.00,"309587 ",100.00,170607,138985,5,309597
"Aonla","Uttar Pradesh",7131,4440,1,11572,"807 ","276909 ",100.00,"276911 ",100.00,153272,123635,4,276911
"Pilibhit","Uttar Pradesh",6599,4503,0,11102,"871 ","345826 ",99.00,"345927 ",100.00,184933,160991,14,345938
"Barkhera","Uttar Pradesh",5837,4129,0,9966,"857 ","291306 ",99.00,"291354 ",100.00,156857,134496,5,291358
"Puranpur","Uttar Pradesh",4852,2691,0,7543,"845 ","348568 ",99.00,"350303 ",100.00,189880,160407,16,350303
"Bisalpur","Uttar Pradesh",6269,4111,0,10380,"850 ","330133 ",99.00,"330212 ",100.00,178536,151668,8,330212
"Katra","Uttar Pradesh",5690,3285,0,8975,"792 ","301903 ",99.00,"302138 ",100.00,168579,133551,13,302143
"Jalalabad","Uttar Pradesh",7286,4134,0,11420,"762 ","323550 ",99.00,"323683 ",100.00,183681,139995,9,323685
"Tilhar","Uttar Pradesh",5961,3613,2,9576,"816 ","310663 ",99.00,"311995 ",100.00,171757,140227,15,311999
"Powayan","Uttar Pradesh",6530,3581,0,10111,"822 ","337856 ",99.00,"338801 ",100.00,185914,152875,12,338801
"Shahjahanpur","Uttar Pradesh",5579,3659,0,9238,"806 ","330022 ",99.00,"330056 ",100.00,182771,147262,23,330056
"Dadraul","Uttar Pradesh",7713,4713,10,12436,"797 ","316946 ",99.00,"317083 ",100.00,176414,140622,47,317083
"PALIA","Uttar Pradesh",4465,3620,0,8085,"851 ","323191 ",99.00,"323249 ",100.00,174619,148623,7,323249
"NIGHASAN","Uttar Pradesh",4349,2107,1,6457,"844 ","316062 ",100.00,"316066 ",100.00,171389,144669,8,316066
"GOLA GOKRANNATH","Uttar Pradesh",5182,2949,0,8131,"848 ","343202 ",100.00,"343202 ",100.00,185686,157502,16,343204
"SRI NAGAR","Uttar Pradesh",3376,1718,1,5095,"843 ","285298 ",99.00,"285369 ",100.00,154851,130510,8,285369
"DHAURAHRA","Uttar Pradesh",3532,1998,1,5531,"834 ","300582 ",99.00,"300642 ",100.00,163952,136665,25,300642
"LAKHIMPUR","Uttar Pradesh",4309,2798,0,7107,"856 ","356012 ",99.00,"356148 ",100.00,191898,164229,21,356148
"KASTA","Uttar Pradesh",3122,1637,0,4759,"837 ","283286 ",100.00,"283286 ",100.00,154238,129037,13,283288
"MOHAMMDI","Uttar Pradesh",6515,4275,2,10792,"824 ","306153 ",99.00,"306211 ",100.00,167861,138342,8,306211
"Maholi","Uttar Pradesh",5435,3788,4,9227,"824 ","331741 ",100.00,"331741 ",100.00,181904,149816,21,331741
"Sitapur","Uttar Pradesh",3981,4291,0,8272,"893 ","353327 ",100.00,"353343 ",100.00,186689,166633,21,353343
"Hargaon","Uttar Pradesh",6314,4948,1,11263,"860 ","289577 ",100.00,"289591 ",100.00,155664,133908,19,289591
"Laharpur","Uttar Pradesh",6513,3841,0,10354,"846 ","307621 ",100.00,"307630 ",100.00,166684,140935,11,307630
"Biswan","Uttar Pradesh",5976,3789,1,9766,"848 ","298880 ",99.00,"298916 ",100.00,161768,137132,16,298916
"Sevata","Uttar Pradesh",6049,2642,2,8693,"813 ","275082 ",99.00,"275107 ",100.00,151742,123358,7,275107
"Mahmoodabad","Uttar Pradesh",5221,2670,0,7891,"813 ","270061 ",99.00,"270155 ",100.00,148979,121171,5,270155
"Sidhauli","Uttar Pradesh",5245,3186,2,8433,"837 ","312173 ",99.00,"312234 ",100.00,169964,142263,7,312234
"Misrikh","Uttar Pradesh",5001,3157,1,8159,"796 ","322164 ",99.00,"323513 ",100.00,180119,143374,20,323513
"Sawaijpur","Uttar Pradesh",7616,6177,0,13793,"786 ","360249 ",99.00,"361402 ",100.00,202406,158990,6,361402
"Shahabad","Uttar Pradesh",6427,6681,0,13108,"858 ","331598 ",99.00,"331779 ",100.00,178562,153195,22,331779
"Hardoi","Uttar Pradesh",6500,5944,0,12444,"838 ","369904 ",99.00,"370624 ",100.00,201673,168944,7,370624
"Gopamau","Uttar Pradesh",7990,8190,1,16181,"832 ","319479 ",99.00,"319837 ",100.00,174614,145222,12,319848
"Sandi","Uttar Pradesh",6349,6998,3,13350,"813 ","304268 ",99.00,"304409 ",100.00,167864,136537,8,304409
"Bilgram-Mallanwan","Uttar Pradesh",2984,5895,0,8879,"837 ","345476 ",99.00,"345766 ",100.00,188250,157508,8,345766
"Balamau","Uttar Pradesh",5295,4315,3,9613,"824 ","335120 ",99.00,"335248 ",100.00,183771,151465,12,335248
"Sandila","Uttar Pradesh",4833,4252,0,9085,"840 ","323404 ",99.00,"323950 ",100.00,176065,147873,12,323950
"Bangermau","Uttar Pradesh",4424,3246,0,7670,"801 ","324221 ",100.00,"324222 ",100.00,179997,144213,12,324222
"Safipur","Uttar Pradesh",4592,2341,0,6933,"781 ","315734 ",100.00,"315734 ",100.00,177240,138489,5,315734
"Mohan","Uttar Pradesh",5959,3726,1,9686,"810 ","314454 ",100.00,"314460 ",100.00,173737,140716,7,314460
"Unnao","Uttar Pradesh",6248,3527,2,9777,"811 ","363190 ",99.00,"363279 ",100.00,200568,162690,21,363279
"Bhagwantnagar","Uttar Pradesh",7690,7894,0,15584,"844 ","407774 ",100.00,"407779 ",100.00,221135,186638,6,407779
"Purwa","Uttar Pradesh",8737,4734,3,13474,"811 ","384914 ",100.00,"384914 ",100.00,212505,172389,20,384914
"Malihabad","Uttar Pradesh",5751,3585,0,9336,"848 ","329200 ",99.00,"329402 ",100.00,178213,151187,2,329402
"Bakshi Kaa Talab","Uttar Pradesh",5545,3361,0,8906,"844 ","354754 ",99.00,"354788 ",100.00,192383,162399,6,354788
"Sarojini Nagar","Uttar Pradesh",6031,3437,0,9468,"828 ","441434 ",99.00,"442104 ",100.00,241836,200260,8,442104
"Lucknow West","Uttar Pradesh",3336,2016,0,5352,"843 ","378742 ",99.00,"379353 ",100.00,205776,173569,8,379353
"Lucknow North","Uttar Pradesh",6976,4748,7,11731,"845 ","374750 ",99.00,"374980 ",100.00,203192,171756,32,374980
"Lucknow East","Uttar Pradesh",4262,3123,0,7385,"869 ","392028 ",100.00,"392039 ",100.00,209744,182282,13,392039
"Lucknow Central","Uttar Pradesh",3158,2314,0,5472,"869 ","353417 ",99.00,"353440 ",100.00,189121,164315,4,353440
"Lucknow Cantt.","Uttar Pradesh",2674,2110,0,4784,"853 ","343547 ",99.00,"343791 ",100.00,185533,158237,21,343791
"Mohanlalganj","Uttar Pradesh",5398,3174,0,8572,"875 ","331812 ",99.00,"331984 ",100.00,177029,154942,13,331984
"Bachhrawan","Uttar Pradesh",4985,3552,1,8538,"870 ","301524 ",99.00,"301852 ",100.00,161442,140390,20,301852
"Tiloi","Uttar Pradesh",5414,4017,2,9433,"871 ","328023 ",100.00,"328024 ",100.00,175353,152653,18,328024
"Harchandpur","Uttar Pradesh",4883,3624,0,8507,"846 ","288053 ",99.00,"288295 ",100.00,156129,132160,6,288295
"Rae Bareli","Uttar Pradesh",4815,2956,0,7771,"862 ","328715 ",99.00,"329003 ",100.00,176678,152319,6,329003
"Salon","Uttar Pradesh",6329,3629,1,9959,"866 ","322840 ",99.00,"322969 ",100.00,173035,149932,2,322969
"Sareni","Uttar Pradesh",5536,3722,0,9258,"840 ","336519 ",99.00,"336877 ",100.00,183072,153796,9,336877
"Unchahar","Uttar Pradesh",7302,5131,0,12433,"875 ","308845 ",99.00,"308863 ",100.00,164732,144116,15,308863
"Jagdishpur","Uttar Pradesh",5406,2389,2,7797,"862 ","340733 ",100.00,"340735 ",100.00,183018,157692,25,340735
"Gauriganj","Uttar Pradesh",5326,2968,2,8296,"883 ","325330 ",100.00,"325330 ",100.00,172723,152576,31,325330
"Amethi","Uttar Pradesh",6616,3776,2,10394,"893 ","318047 ",99.00,"318069 ",100.00,167962,150055,52,318069
"Isauli","Uttar Pradesh",4443,2889,1,7333,"878 ","322450 ",100.00,"322463 ",100.00,171739,150715,9,322463
"Sultanpur","Uttar Pradesh",4202,2487,0,6689,"863 ","336716 ",100.00,"336716 ",100.00,180740,155971,5,336716
"Sadar","Uttar Pradesh",4996,2616,1,7613,"858 ","304641 ",100.00,"304652 ",100.00,163983,140660,9,304652
"Lambhua","Uttar Pradesh",5719,2949,0,8668,"863 ","327229 ",99.00,"327316 ",100.00,175664,151646,6,327316
"Kadipur","Uttar Pradesh",5506,3558,1,9065,"870 ","338328 ",99.00,"338411 ",100.00,180973,157434,4,338411
"Kaimganj","Uttar Pradesh",8894,6581,0,15475,"800 ","361199 ",99.00,"361227 ",100.00,200701,160505,21,361227
"Amritpur","Uttar Pradesh",4817,3522,0,8339,"793 ","281868 ",99.00,"281909 ",100.00,157217,124681,11,281909
"Farrukhabad","Uttar Pradesh",4813,3217,0,8030,"828 ","333340 ",100.00,"333346 ",100.00,182318,151013,15,333346
"Bhojpur","Uttar Pradesh",4057,2788,0,6845,"821 ","289063 ",100.00,"289064 ",100.00,158693,130357,14,289064
"Chhibramau","Uttar Pradesh",10167,7329,3,17499,"809 ","414143 ",100.00,"414146 ",100.00,228905,185226,15,414146
"Tirwa","Uttar Pradesh",6416,4472,1,10889,"789 ","338984 ",100.00,"338984 ",100.00,189469,149517,7,338993
"Kannauj","Uttar Pradesh",7736,6863,1,14600,"817 ","380908 ",100.00,"380910 ",100.00,209605,171310,5,380920
"Jaswantnagar","Uttar Pradesh",5107,3378,0,8485,"798 ","349740 ",99.00,"350291 ",100.00,194860,155425,6,350291
"Etawah","Uttar Pradesh",4507,3136,0,7643,"832 ","362928 ",99.00,"363391 ",100.00,198314,165054,23,363391
"Bharthana","Uttar Pradesh",6395,4601,1,10997,"798 ","380148 ",99.00,"380389 ",100.00,211591,168773,25,380389
"Bidhuna","Uttar Pradesh",4820,2892,3,7715,"812 ","341124 ",100.00,"341128 ",100.00,188267,152845,16,341128
"Dibiyapur","Uttar Pradesh",4849,3120,1,7970,"812 ","298771 ",100.00,"298773 ",100.00,164858,133908,7,298773
"Auraiya","Uttar Pradesh",5046,3559,3,8608,"823 ","314674 ",100.00,"314683 ",100.00,172619,142026,38,314683
"Rasulabad","Uttar Pradesh",3932,3723,1,7656,"812 ","296366 ",99.00,"296415 ",100.00,163625,132783,7,296415
"Akbarpur - Raniya","Uttar Pradesh",3576,2621,0,6197,"831 ","297577 ",99.00,"297756 ",100.00,162577,135147,32,297756
"Sikandra","Uttar Pradesh",3978,2921,1,6900,"816 ","309213 ",99.00,"309248 ",100.00,170291,138950,7,309248
"Bhognipur","Uttar Pradesh",5151,4111,2,9264,"826 ","321730 ",99.00,"321797 ",100.00,176239,145541,17,321797
"Bilhaur","Uttar Pradesh",5051,3846,1,8898,"811 ","368830 ",100.00,"368838 ",100.00,203605,165222,11,368838
"Bithoor","Uttar Pradesh",4761,2811,1,7573,"786 ","344566 ",100.00,"344566 ",100.00,192890,151654,22,344566
"Kalyanpur","Uttar Pradesh",2725,1844,0,4569,"834 ","324795 ",100.00,"324795 ",100.00,177086,147700,10,324796
"Govindnagar","Uttar Pradesh",3500,2309,0,5809,"801 ","353264 ",100.00,"353269 ",100.00,196107,157143,19,353269
"Sishamau","Uttar Pradesh",2173,1686,0,3859,"821 ","265648 ",100.00,"265654 ",100.00,145881,119773,0,265654
"Arya Nagar","Uttar Pradesh",2283,1533,0,3816,"799 ","264278 ",100.00,"264280 ",100.00,146886,117384,10,264280
"KIDWAI NAGAR","Uttar Pradesh",4160,2719,1,6880,"844 ","349115 ",100.00,"349120 ",100.00,189292,159810,18,349120
"Kanpur Cantt.","Uttar Pradesh",3454,2232,0,5686,"789 ","320761 ",100.00,"320765 ",100.00,179305,141441,19,320765
"Maharajpur","Uttar Pradesh",4958,2672,1,7631,"803 ","425305 ",100.00,"425305 ",100.00,235909,189385,16,425310
"Ghatampur","Uttar Pradesh",4950,3121,0,8071,"794 ","317406 ",100.00,"317412 ",100.00,176974,140431,7,317412
"Madhaugarh","Uttar Pradesh",5833,4011,0,9844,"801 ","415948 ",99.00,"416001 ",100.00,230924,185072,5,416001
"Kalpi","Uttar Pradesh",6060,3428,0,9488,"795 ","369140 ",99.00,"369323 ",100.00,205765,163555,4,369324
"Orai","Uttar Pradesh",6812,4158,0,10970,"831 ","422550 ",99.00,"422784 ",100.00,230891,191882,11,422784
"Babina","Uttar Pradesh",4633,2849,0,7482,"831 ","303810 ",99.00,"303925 ",100.00,166025,137890,10,303925
"Jhansi Nagar","Uttar Pradesh",3562,2248,1,5811,"841 ","389246 ",99.00,"389298 ",100.00,211452,177825,21,389298
"Mauranipur","Uttar Pradesh",5805,3457,0,9262,"859 ","383922 ",99.00,"384141 ",100.00,206639,177485,17,384141
"Garautha","Uttar Pradesh",5014,3095,0,8109,"838 ","327900 ",99.00,"328967 ",100.00,178948,150011,8,328967
"Lalitpur","Uttar Pradesh",9448,7539,0,16987,"886 ","413899 ",99.00,"413999 ",100.00,219491,194508,0,413999
"Mehroni","Uttar Pradesh",10548,8923,0,19471,"905 ","384065 ",100.00,"384082 ",100.00,201597,182485,0,384082
"Hamirpur","Uttar Pradesh",5232,5401,2,10635,"841 ","399898 ",100.00,"399901 ",100.00,217257,182637,7,399901
"Rath","Uttar Pradesh",5487,6636,0,12123,"862 ","393631 ",99.00,"393642 ",100.00,211441,182207,3,393651
"Mahoba","Uttar Pradesh",5636,3823,0,9459,"809 ","294769 ",100.00,"294772 ",100.00,162978,131793,1,294772
"Charkhari","Uttar Pradesh",6583,5320,0,11903,"837 ","327172 ",99.00,"327202 ",100.00,178103,149090,9,327202
"Tindwari","Uttar Pradesh",5800,3626,1,9427,"780 ","278549 ",94.00,"293347 ",100.00,164796,128543,8,293347
"Baberu","Uttar Pradesh",5488,4187,0,9675,"793 ","310556 ",99.00,"312910 ",100.00,174499,138394,15,312908
"Naraini","Uttar Pradesh",6734,4865,0,11599,"813 ","315773 ",99.00,"317048 ",100.00,174820,142214,14,317048
"Banda","Uttar Pradesh",4757,3404,0,8161,"796 ","285524 ",99.00,"287798 ",100.00,160194,127592,12,287798
"Chitrakoot","Uttar Pradesh",8233,8412,2,16647,"826 ","342134 ",100.00,"342143 ",100.00,187340,154795,8,342143
"Manikpur","Uttar Pradesh",9583,7757,0,17340,"814 ","314436 ",99.00,"314460 ",100.00,173367,141082,11,314460
"Jahanabad","Uttar Pradesh",4591,3187,2,7780,"823 ","288736 ",100.00,"288741 ",100.00,158384,130355,2,288741
"Bindki","Uttar Pradesh",4484,3527,0,8011,"847 ","290430 ",99.00,"290454 ",100.00,157278,133176,0,290454
"Fatehpur","Uttar Pradesh",3807,3158,0,6965,"839 ","325684 ",100.00,"325687 ",100.00,177078,148600,9,325687
"Ayah Shah","Uttar Pradesh",4076,4336,1,8413,"828 ","254630 ",100.00,"254632 ",100.00,139260,115369,3,254632
"Husainganj","Uttar Pradesh",4196,3252,0,7448,"841 ","279375 ",99.00,"279439 ",100.00,151751,127682,6,279439
"Khaga","Uttar Pradesh",3950,2887,0,6837,"827 ","305930 ",99.00,"305994 ",100.00,167462,138524,8,305994
"Rampur Khas","Uttar Pradesh",5121,2998,2,8121,"852 ","303596 ",99.00,"304177 ",100.00,164194,139963,20,304177
"Babaganj","Uttar Pradesh",4785,2204,12,7001,"852 ","300235 ",99.00,"300235 ",99.00,162094,138075,85,300254
"Kunda","Uttar Pradesh",4920,2101,6,7027,"820 ","335617 ",100.00,"335621 ",100.00,184328,151197,96,335621
"Bishwavnathganj","Uttar Pradesh",5279,2796,2,8077,"849 ","369876 ",99.00,"370944 ",99.00,200694,170295,17,371006
"Pratapgarh","Uttar Pradesh",4818,2753,5,7576,"851 ","328260 ",99.00,"329752 ",100.00,178148,151581,37,329766
"Patti","Uttar Pradesh",6189,3411,2,9602,"846 ","344410 ",99.00,"344588 ",100.00,186700,157854,34,344588
"Raniganj","Uttar Pradesh",4378,2071,1,6450,"879 ","308853 ",100.00,"308857 ",100.00,164325,144523,9,308857
"Sirathu","Uttar Pradesh",4056,2102,0,6158,"813 ","328867 ",99.00,"328930 ",100.00,181407,147512,11,328930
"Manjhanpur","Uttar Pradesh",7348,3175,1,10524,"797 ","365490 ",99.00,"365824 ",100.00,203579,162228,17,365824
"Chail","Uttar Pradesh",6038,2585,0,8623,"804 ","342287 ",99.00,"342347 ",100.00,189722,152615,10,342347
"Phaphamau","Uttar Pradesh",7072,3121,1,10194,"810 ","333442 ",99.00,"333539 ",100.00,184225,149304,10,333539
"Soraon","Uttar Pradesh",6653,3490,0,10143,"831 ","337227 ",99.00,"337476 ",100.00,184303,153155,18,337476
"Phulpur","Uttar Pradesh",5868,2470,1,8339,"776 ","341187 ",100.00,"341195 ",100.00,192063,149111,21,341195
"Pratappur","Uttar Pradesh",7151,3530,1,10682,"808 ","344156 ",99.00,"344244 ",100.00,190396,153819,29,344244
"Handia","Uttar Pradesh",6509,3633,0,10142,"791 ","342175 ",100.00,"342175 ",100.00,191007,151129,39,342175
"Meja","Uttar Pradesh",5296,2567,2,7865,"791 ","292944 ",100.00,"292957 ",100.00,163545,129396,16,292957
"Karachhana","Uttar Pradesh",5069,2381,3,7453,"807 ","314332 ",100.00,"314335 ",100.00,173947,140375,13,314335
"Allahabad West","Uttar Pradesh",2939,1496,1,4436,"789 ","356905 ",100.00,"356906 ",100.00,199500,157389,17,356906
"Allahabad North","Uttar Pradesh",2718,2027,6,4751,"787 ","367724 ",99.00,"367841 ",100.00,205808,161989,44,367841
"Allahabad South","Uttar Pradesh",2318,1843,5,4166,"809 ","337277 ",99.00,"337347 ",100.00,186473,150809,65,337347
"Bara","Uttar Pradesh",5678,3154,1,8833,"826 ","301493 ",99.00,"302927 ",100.00,165914,137003,10,302927
"Koraon","Uttar Pradesh",6081,3175,0,9256,"846 ","313199 ",99.00,"313215 ",100.00,169687,143510,18,313215
"Kursi","Uttar Pradesh",5136,3804,0,8940,"863 ","359437 ",99.00,"359633 ",100.00,193052,166579,2,359633
"Ram Nagar","Uttar Pradesh",5676,3839,0,9515,"825 ","306160 ",99.00,"307814 ",100.00,168622,139189,3,307814
"Barabanki","Uttar Pradesh",5081,3496,3,8580,"851 ","348130 ",99.00,"348249 ",100.00,188093,160129,27,348249
"Zaidpur","Uttar Pradesh",6446,4617,0,11063,"868 ","354567 ",99.00,"354654 ",100.00,189822,164816,16,354654
"Dariyabad","Uttar Pradesh",6391,4202,1,10594,"854 ","373530 ",99.00,"373767 ",100.00,201573,172182,12,373767
"Rudauli","Uttar Pradesh",6392,2838,0,9230,"840 ","317918 ",99.00,"317940 ",100.00,172781,145150,9,317940
"Haidergarh","Uttar Pradesh",4451,2756,0,7207,"874 ","324224 ",100.00,"324224 ",100.00,173035,151178,11,324224
"Milkipur","Uttar Pradesh",4470,2349,0,6819,"871 ","328743 ",100.00,"328744 ",100.00,175698,153044,2,328744
"Bikapur","Uttar Pradesh",5734,3031,0,8765,"865 ","345566 ",100.00,"345572 ",100.00,185337,160234,1,345572
"Ayodhya","Uttar Pradesh",4648,2573,2,7223,"849 ","329136 ",100.00,"329136 ",100.00,177977,151138,21,329136
"Goshainganj","Uttar Pradesh",6283,3380,2,9665,"860 ","363368 ",100.00,"363372 ",100.00,195398,167963,11,363372
"Katehari","Uttar Pradesh",6408,3628,6,10042,"862 ","351634 ",99.00,"351729 ",100.00,188856,162838,35,351729
"Tanda","Uttar Pradesh",5375,3479,0,8854,"867 ","296686 ",99.00,"296802 ",100.00,159007,137792,3,296802
"Alapur","Uttar Pradesh",6154,3798,2,9954,"836 ","308227 ",99.00,"308261 ",100.00,167908,140340,13,308261
"Jalalpur","Uttar Pradesh",5795,3188,0,8983,"849 ","366006 ",99.00,"366139 ",100.00,198058,168072,9,366139
"Akbarpur","Uttar Pradesh",5520,3320,2,8842,"851 ","288752 ",100.00,"288764 ",100.00,156030,132716,18,288764
"Balha","Uttar Pradesh",7051,5687,0,12738,"840 ","324570 ",99.00,"324681 ",100.00,176421,148254,6,324681
"Nanpara","Uttar Pradesh",4666,3922,0,8588,"853 ","309178 ",99.00,"309567 ",100.00,167051,142505,11,309567
"Matera","Uttar Pradesh",7238,5356,1,12595,"854 ","303329 ",99.00,"303464 ",100.00,163650,139788,26,303464
"Mahasi","Uttar Pradesh",7663,6048,0,13711,"865 ","304978 ",99.00,"305135 ",100.00,163634,141476,25,305135
"Bahraich","Uttar Pradesh",5851,4944,0,10795,"854 ","333995 ",100.00,"333995 ",100.00,180168,153800,27,333995
"Payagpur","Uttar Pradesh",6158,4430,1,10589,"857 ","336161 ",99.00,"336208 ",100.00,181068,155119,21,336208
"Kaiserganj","Uttar Pradesh",8856,7735,2,16593,"849 ","352265 ",99.00,"352450 ",100.00,190655,161779,16,352450
"Bhinga","Uttar Pradesh",8199,6007,0,14206,"837 ","338193 ",99.00,"338543 ",100.00,184297,154235,11,338543
"Shrawasti","Uttar Pradesh",11101,9723,1,20825,"861 ","368337 ",99.00,"368551 ",100.00,198079,170461,11,368551
"Tulsipur","Uttar Pradesh",4831,3374,1,8206,"815 ","341925 ",99.00,"342191 ",100.00,188548,153635,8,342191
"Gainsari","Uttar Pradesh",5134,3770,4,8908,"841 ","311221 ",98.00,"316010 ",100.00,171649,144348,13,316010
"Utraula","Uttar Pradesh",6561,2941,0,9502,"787 ","389325 ",99.00,"389514 ",100.00,217927,171579,8,389514
"Balrampur","Uttar Pradesh",5890,3699,1,9590,"804 ","388372 ",99.00,"388848 ",100.00,215498,173344,6,388848
"Mehnaun","Uttar Pradesh",5123,2556,0,7679,"822 ","339351 ",100.00,"339354 ",100.00,186269,153075,10,339354
"Gonda","Uttar Pradesh",3796,2341,0,6137,"843 ","316070 ",100.00,"316078 ",100.00,171458,144603,17,316078
"Katra Bazar","Uttar Pradesh",3858,1699,0,5557,"835 ","337312 ",99.00,"337435 ",100.00,183922,153514,6,337442
"Colonelganj","Uttar Pradesh",3454,1642,0,5096,"820 ","295952 ",99.00,"296111 ",99.00,162736,133406,9,296151
"Tarabganj","Uttar Pradesh",4169,2679,0,6848,"837 ","337855 ",99.00,"337995 ",100.00,183985,154004,9,337998
"Mankapur","Uttar Pradesh",4209,2385,1,6595,"840 ","304387 ",99.00,"304427 ",100.00,165443,138979,5,304427
"Gaura","Uttar Pradesh",3969,4210,0,8179,"843 ","310858 ",100.00,"310859 ",100.00,168673,142188,3,310864
"Shohratgarh","Uttar Pradesh",4362,1884,0,6246,"844 ","309769 ",100.00,"309784 ",100.00,168022,141737,25,309784
"Kapilvastu","Uttar Pradesh",6945,2942,1,9888,"836 ","390504 ",99.00,"390663 ",100.00,212760,177889,14,390663
"Bansi","Uttar Pradesh",5813,2677,0,8490,"817 ","340910 ",99.00,"341026 ",100.00,187623,153374,29,341026
"Itwa","Uttar Pradesh",4914,1877,1,6792,"832 ","289494 ",99.00,"289909 ",99.00,158244,131679,18,289941
"Doomariyaganj","Uttar Pradesh",7320,3772,1,11093,"820 ","360576 ",99.00,"360699 ",100.00,198195,162479,25,360699
"Harraiya","Uttar Pradesh",5851,2787,0,8638,"868 ","348775 ",99.00,"349692 ",100.00,187229,162453,10,349692
"Kaptanganj","Uttar Pradesh",5112,2411,1,7524,"859 ","331672 ",99.00,"331764 ",100.00,178456,153286,22,331764
"Rudhauli","Uttar Pradesh",8060,3230,1,11291,"844 ","383180 ",100.00,"383186 ",100.00,207763,175397,26,383186
"Basti Sadar","Uttar Pradesh",5064,2599,0,7663,"856 ","326761 ",99.00,"326778 ",100.00,176052,150715,11,326778
"Mahadewa","Uttar Pradesh",5725,2256,0,7981,"851 ","328762 ",99.00,"328805 ",100.00,177578,151170,57,328805
"Menhdawal","Uttar Pradesh",4861,1989,2,6852,"805 ","424004 ",100.00,"424024 ",100.00,234928,189071,25,424024
"Khalilabad","Uttar Pradesh",6773,3409,1,10183,"814 ","411665 ",99.00,"411730 ",100.00,227007,184710,13,411730
"Dhanghata","Uttar Pradesh",3579,1580,0,5159,"857 ","352232 ",99.00,"352434 ",100.00,189759,162664,11,352434
"Pharenda","Uttar Pradesh",5796,2828,2,8626,"819 ","310511 ",99.00,"310621 ",100.00,170774,139827,20,310621
"Nautanwa","Uttar Pradesh",4904,2264,5,7173,"847 ","308068 ",99.00,"308087 ",100.00,166773,141273,41,308087
"Siswa","Uttar Pradesh",6646,4854,0,11500,"841 ","340607 ",99.00,"340835 ",100.00,185086,155743,6,340835
"Maharajganj","Uttar Pradesh",7841,5501,1,13343,"860 ","359293 ",99.00,"359411 ",100.00,193215,166174,22,359411
"Paniyara","Uttar Pradesh",7858,4763,3,12624,"824 ","367927 ",99.00,"367970 ",100.00,201681,166260,29,367970
"Caimpiyarganj","Uttar Pradesh",7131,4752,1,11884,"798 ","343437 ",99.00,"343507 ",100.00,191077,152417,13,343507
"Pipraich","Uttar Pradesh",7799,3564,1,11364,"782 ","356428 ",99.00,"356778 ",100.00,200169,156598,11,356778
"Gorakhpur Urban","Uttar Pradesh",4034,2573,0,6607,"805 ","374958 ",99.00,"375404 ",100.00,207917,167461,26,375404
"Gorakhpur Rural","Uttar Pradesh",5536,2970,0,8506,"786 ","354081 ",99.00,"354210 ",100.00,198274,155917,19,354210
"Sahajanwa","Uttar Pradesh",7236,3677,1,10914,"786 ","334566 ",99.00,"334799 ",100.00,187489,147288,22,334799
"Khajani","Uttar Pradesh",6181,3893,0,10074,"780 ","341287 ",99.00,"341478 ",100.00,191812,149650,15,341477
"Chauri-Chaura","Uttar Pradesh",5543,3060,1,8604,"781 ","325049 ",99.00,"325173 ",100.00,182587,142570,16,325173
"Bansgaon","Uttar Pradesh",6926,3470,1,10397,"777 ","343771 ",99.00,"343909 ",100.00,193534,150360,15,343909
"Chillupar","Uttar Pradesh",6507,3510,3,10020,"787 ","409170 ",99.00,"409247 ",100.00,228947,180283,17,409247
"Khadda","Uttar Pradesh",5451,1947,0,7398,"791 ","290200 ",99.00,"290427 ",100.00,162147,128248,45,290440
"Padrauna","Uttar Pradesh",3634,1241,0,4875,"802 ","329125 ",99.00,"329589 ",99.00,183003,146778,7,329788
"Tamkuhi Raj","Uttar Pradesh",5707,2470,1,8178,"789 ","352552 ",99.00,"352824 ",100.00,197080,155545,199,352824
"Fazilnagar","Uttar Pradesh",5180,2167,0,7347,"794 ","356580 ",99.00,"356966 ",100.00,199000,157939,42,356981
"Kushinagar","Uttar Pradesh",2411,1044,0,3455,"802 ","336511 ",99.00,"337083 ",100.00,187024,150031,28,337083
"Hata","Uttar Pradesh",6473,3486,0,9959,"820 ","340578 ",99.00,"340607 ",100.00,187176,153425,6,340607
"Ramkola","Uttar Pradesh",6384,3267,0,9651,"793 ","324681 ",99.00,"324810 ",100.00,181130,143660,20,324810
"Rudrapur","Uttar Pradesh",3165,1306,0,4471,"796 ","301178 ",99.00,"301330 ",100.00,167811,133514,5,301330
"Deoria","Uttar Pradesh",4941,2481,0,7422,"797 ","336670 ",99.00,"336689 ",100.00,187386,149293,10,336689
"Pathardeva","Uttar Pradesh",6810,3490,1,10301,"828 ","342854 ",100.00,"342860 ",100.00,187593,155255,12,342860
"Rampur Karkhana","Uttar Pradesh",6301,2964,0,9265,"815 ","350644 ",100.00,"350651 ",100.00,193204,157424,23,350651
"Bhatpar Rani","Uttar Pradesh",5552,2099,1,7652,"810 ","315405 ",100.00,"315414 ",100.00,174268,141137,9,315414
"Salempur","Uttar Pradesh",5601,3037,0,8638,"852 ","317749 ",100.00,"317749 ",100.00,171562,146188,6,317756
"Barhaj","Uttar Pradesh",4193,1822,0,6015,"802 ","295756 ",99.00,"295794 ",100.00,164169,131613,12,295794
"Atrauliya","Uttar Pradesh",6066,2852,0,8918,"826 ","345622 ",100.00,"345630 ",100.00,189250,156368,12,345630
"Gopalpur","Uttar Pradesh",5585,2587,0,8172,"799 ","313826 ",99.00,"314033 ",100.00,174541,139474,18,314033
"Sagri","Uttar Pradesh",5685,2773,0,8458,"809 ","307562 ",99.00,"307698 ",100.00,170092,137587,19,307698
"Mubarakpur","Uttar Pradesh",5823,2971,1,8795,"784 ","300908 ",99.00,"300933 ",100.00,168669,132238,26,300933
"Azamgarh","Uttar Pradesh",6170,3067,0,9237,"808 ","359084 ",99.00,"359168 ",100.00,198689,160462,17,359168
"Nizamabad","Uttar Pradesh",4453,1852,0,6305,"809 ","285799 ",99.00,"285927 ",100.00,158066,127833,28,285927
"Phoolpur Pawai","Uttar Pradesh",3462,1609,1,5072,"821 ","288564 ",99.00,"288700 ",100.00,158563,130132,5,288700
"Didarganj","Uttar Pradesh",4042,1676,2,5720,"834 ","320323 ",99.00,"321840 ",100.00,175441,146381,18,321840
"Lalganj","Uttar Pradesh",5566,2898,1,8465,"846 ","364474 ",99.00,"364502 ",100.00,197393,167067,42,364502
"Mehnagar","Uttar Pradesh",5558,2679,1,8238,"822 ","362291 ",100.00,"362294 ",100.00,198855,163420,19,362294
"Madhuban","Uttar Pradesh",6073,2840,0,8913,"803 ","359342 ",99.00,"359786 ",100.00,199555,160169,62,359786
"Ghosi","Uttar Pradesh",5110,2424,1,7535,"816 ","377953 ",99.00,"378272 ",100.00,208228,170004,40,378272
"Muhammadabad- Gohna (SC)","Uttar Pradesh",6069,3956,1,10026,"823 ","345907 ",99.00,"346113 ",100.00,189831,156276,6,346113
"Mau","Uttar Pradesh",5619,3133,0,8752,"830 ","400109 ",99.00,"401176 ",100.00,219257,181906,13,401176
"Belthara Road","Uttar Pradesh",2928,1715,0,4643,"835 ","317757 ",99.00,"317875 ",100.00,173209,144570,96,317875
"Rasara","Uttar Pradesh",3666,1690,0,5356,"809 ","309664 ",99.00,"310171 ",100.00,171464,138686,21,310171
"Sikanderpur","Uttar Pradesh",2420,1661,0,4081,"845 ","280263 ",99.00,"280594 ",100.00,152106,128488,0,280594
"Phephana","Uttar Pradesh",3108,2365,0,5473,"842 ","300167 ",99.00,"301330 ",100.00,163602,137722,6,301330
"Ballia Nagar","Uttar Pradesh",2931,1962,0,4893,"802 ","341792 ",99.00,"342579 ",100.00,190096,152479,4,342579
"Bansdih","Uttar Pradesh",3130,2110,0,5240,"841 ","349906 ",99.00,"352256 ",100.00,191363,160881,12,352256
"Bairia","Uttar Pradesh",3389,2120,1,5510,"803 ","316371 ",99.00,"316912 ",100.00,175790,141109,13,316912
"Badlapur","Uttar Pradesh",4953,3016,0,7969,"876 ","322421 ",100.00,"322421 ",100.00,171841,150586,3,322430
"Shahganj","Uttar Pradesh",5249,2560,1,7810,"827 ","341397 ",100.00,"341405 ",100.00,186898,154494,13,341405
"Jaunpur","Uttar Pradesh",6543,3439,0,9982,"818 ","384097 ",99.00,"384228 ",100.00,211362,172853,13,384228
"Malhani","Uttar Pradesh",5001,2457,2,7460,"862 ","339201 ",100.00,"339207 ",100.00,182199,156994,14,339207
"Mungra Badshahpur","Uttar Pradesh",5687,2461,1,8149,"843 ","350324 ",100.00,"350330 ",100.00,190065,160253,12,350330
"Machhlishahr S.C.","Uttar Pradesh",6488,2831,2,9321,"845 ","374972 ",100.00,"374979 ",100.00,203260,171708,11,374979
"Mariyahu","Uttar Pradesh",6068,2681,1,8750,"855 ","315077 ",99.00,"315096 ",100.00,169871,145220,5,315096
"Zafrabad","Uttar Pradesh",5126,2604,1,7731,"844 ","356987 ",100.00,"356992 ",100.00,193579,163403,10,356992
"Kerakat S.C.","Uttar Pradesh",7292,3482,0,10774,"872 ","402656 ",100.00,"402656 ",100.00,215083,187569,14,402666
"Jakhanian","Uttar Pradesh",7301,3873,1,11175,"837 ","386352 ",100.00,"386355 ",100.00,210314,176028,13,386355
"Saidpur","Uttar Pradesh",5839,2945,3,8787,"833 ","340037 ",99.00,"340267 ",100.00,185583,154670,14,340267
"Ghazipur","Uttar Pradesh",4325,2323,1,6649,"839 ","315546 ",99.00,"315801 ",100.00,171755,144038,8,315801
"Jangipur","Uttar Pradesh",5464,2229,0,7693,"830 ","322717 ",99.00,"322905 ",100.00,176440,146457,8,322905
"Zahoorabad","Uttar Pradesh",5108,2792,1,7901,"834 ","354872 ",100.00,"354873 ",100.00,193531,161332,10,354873
"Mohammadabad","Uttar Pradesh",5579,2744,1,8324,"817 ","376443 ",99.00,"376485 ",100.00,207195,169273,17,376485
"Zamania","Uttar Pradesh",5181,2411,1,7593,"810 ","369499 ",99.00,"369823 ",100.00,204290,165526,7,369823
"Mughalsarai","Uttar Pradesh",5453,2596,0,8049,"777 ","348511 ",99.00,"348545 ",100.00,196089,152398,58,348545
"Sakaldiha","Uttar Pradesh",5089,2355,0,7444,"796 ","302030 ",99.00,"302051 ",100.00,168135,133907,9,302051
"Saiyadraja","Uttar Pradesh",4848,2054,1,6903,"796 ","300609 ",100.00,"300613 ",100.00,167400,133190,23,300613
"Chakia","Uttar Pradesh",5508,3114,0,8622,"841 ","344942 ",100.00,"344942 ",100.00,187326,157604,12,344942
"Pindra","Uttar Pradesh",7490,4034,2,11526,"817 ","329713 ",99.00,"330279 ",100.00,181806,148465,8,330279
"Ajagara","Uttar Pradesh",6626,3722,0,10348,"824 ","320893 ",99.00,"321189 ",100.00,176036,145138,15,321189
"Shivpur","Uttar Pradesh",5818,2738,1,8557,"783 ","311075 ",99.00,"311439 ",100.00,174685,136743,11,311439
"Rohaniya","Uttar Pradesh",5898,2847,0,8745,"774 ","333256 ",99.00,"333898 ",100.00,188226,145658,14,333898
"Varanasi North","Uttar Pradesh",4251,2464,0,6715,"785 ","346411 ",99.00,"346768 ",100.00,194299,152444,25,346768
"Varanasi South","Uttar Pradesh",2938,1846,2,4786,"783 ","268477 ",99.00,"268847 ",100.00,150814,118017,16,268847
"Varanasi Cantt.","Uttar Pradesh",3465,2159,0,5624,"787 ","358788 ",99.00,"360966 ",100.00,201991,158959,16,360966
"Sevapuri","Uttar Pradesh",6123,3188,1,9312,"803 ","298605 ",99.00,"298981 ",100.00,165805,133166,10,298981
"Bhadohi","Uttar Pradesh",6224,4910,0,11134,"821 ","398660 ",99.00,"399025 ",100.00,219101,179895,29,399025
"Gyanpur","Uttar Pradesh",6047,3914,2,9963,"805 ","339830 ",99.00,"340036 ",100.00,188413,151603,20,340036
"Aurai","Uttar Pradesh",3928,2384,0,6312,"792 ","331711 ",99.00,"332070 ",100.00,185318,146720,32,332070
"Chhanbey","Uttar Pradesh",6528,4243,1,10772,"836 ","327194 ",99.00,"328330 ",100.00,178845,149430,55,328330
"Mirzapur","Uttar Pradesh",5337,4055,0,9392,"800 ","356937 ",99.00,"357303 ",100.00,198441,158841,21,357303
"Majhawan","Uttar Pradesh",6163,4059,1,10223,"810 ","350239 ",99.00,"350619 ",100.00,193649,156942,28,350619
"Chunar","Uttar Pradesh",5137,3773,1,8911,"844 ","319935 ",99.00,"320534 ",100.00,173836,146687,11,320534
"Marihan","Uttar Pradesh",5094,5073,0,10167,"881 ","334270 ",99.00,"334402 ",100.00,177807,156584,11,334402
"Ghorawal","Uttar Pradesh",7141,4069,1,11211,"840 ","338326 ",100.00,"338326 ",100.00,183910,154406,10,338326
"Robertsganj","Uttar Pradesh",8448,4616,1,13065,"824 ","307352 ",99.00,"307376 ",100.00,168550,138823,3,307376
"Obra","Uttar Pradesh",4485,2164,0,6649,"726 ","287576 ",99.00,"287605 ",100.00,166580,121014,11,287605
"Duddhi","Uttar Pradesh",3780,2153,0,5933,"826 ","279818 ",100.00,"279828 ",100.00,153236,126590,2,279828
"Purola","Uttarakhand",1286,839,0,2125,"921 ","62235 ",100.00,"62235 ",100.00,32389,29846,0,62235
"Yamunotri","Uttarakhand",1413,834,0,2247,"942 ","64702 ",100.00,"64702 ",100.00,33324,31378,0,64702
"Gangotri","Uttarakhand",1521,982,0,2503,"927 ","74279 ",100.00,"74279 ",100.00,38547,35732,0,74279
"Badrinath","Uttarakhand",1530,898,0,2428,"925 ","91104 ",100.00,"91104 ",100.00,47339,43765,0,91104
"Tharali","Uttarakhand",2000,1072,0,3072,"954 ","92848 ",100.00,"92848 ",100.00,47510,45336,2,92848
"Karnprayag","Uttarakhand",1460,854,0,2314,"975 ","84558 ",100.00,"84558 ",100.00,42809,41749,0,84558
"Kedarnath","Uttarakhand",1282,746,0,2028,"1031 ","75862 ",100.00,"75862 ",100.00,37344,38518,0,75862
"Rudraprayag","Uttarakhand",1550,742,0,2292,"1008 ","88749 ",100.00,"88749 ",100.00,44205,44544,0,88749
"Ghanshali","Uttarakhand",1725,916,0,2641,"976 ","84552 ",100.00,"84552 ",100.00,42794,41758,0,84552
"Deoprayag","Uttarakhand",1361,792,0,2153,"986 ","74616 ",100.00,"74616 ",100.00,37575,37041,0,74616
"Narendranagar","Uttarakhand",1421,797,0,2218,"898 ","78419 ",100.00,"78419 ",100.00,41319,37100,0,78419
"Pratapnagar","Uttarakhand",1348,827,0,2175,"963 ","76224 ",100.00,"76224 ",100.00,38829,37395,0,76224
"Tehri","Uttarakhand",1126,650,0,1776,"937 ","75183 ",100.00,"75183 ",100.00,38813,36370,0,75183
"Dhanolti","Uttarakhand",1438,960,0,2398,"924 ","71385 ",100.00,"71385 ",100.00,37108,34277,0,71385
"Chakrata","Uttarakhand",1376,1036,0,2412,"822 ","93348 ",100.00,"93348 ",100.00,51227,42121,0,93348
"Vikasnagar","Uttarakhand",1534,930,0,2464,"866 ","100303 ",100.00,"100303 ",100.00,53740,46563,0,100303
"Sahaspur","Uttarakhand",2155,1319,0,3474,"894 ","125569 ",100.00,"125569 ",100.00,66308,59261,0,125569
"Dharampur","Uttarakhand",1763,1067,0,2830,"837 ","141041 ",100.00,"141041 ",100.00,76780,64260,1,141041
"Raipur","Uttarakhand",1444,994,0,2438,"889 ","132683 ",100.00,"132683 ",100.00,70252,62431,0,132683
"Rajpur Road","Uttarakhand",1039,733,0,1772,"887 ","105332 ",100.00,"105332 ",100.00,55807,49525,0,105332
"Dehradun Cantt.","Uttarakhand",1054,766,0,1820,"863 ","109614 ",100.00,"109614 ",100.00,58834,50780,0,109614
"Mussoorie","Uttarakhand",1229,872,0,2101,"896 ","109662 ",100.00,"109662 ",100.00,57824,51838,0,109662
"Doiwala","Uttarakhand",1417,968,0,2385,"909 ","119333 ",100.00,"119333 ",100.00,62514,56819,0,119333
"Rishikesh","Uttarakhand",1593,1092,0,2685,"887 ","129881 ",100.00,"129881 ",100.00,68847,61034,0,129881
"Hardwar","Uttarakhand",1284,774,0,2058,"793 ","129408 ",100.00,"129408 ",100.00,72186,57219,3,129408
"B.H.E.L. ranipur","Uttarakhand",1494,793,0,2287,"846 ","124808 ",100.00,"124808 ",100.00,67597,57211,0,124808
"Jwalapur","Uttarakhand",1954,862,0,2816,"830 ","96357 ",100.00,"96357 ",100.00,52645,43712,0,96357
"Bhagwanpur","Uttarakhand",1759,738,0,2497,"821 ","104419 ",100.00,"104419 ",100.00,57329,47090,0,104419
"Jhabrera","Uttarakhand",1841,610,0,2451,"824 ","100211 ",100.00,"100211 ",100.00,54928,45283,0,100211
"Pirankaliyar","Uttarakhand",1462,579,0,2041,"839 ","98058 ",100.00,"98058 ",100.00,53314,44744,0,98058
"Roorkee","Uttarakhand",984,597,0,1581,"868 ","102201 ",100.00,"102201 ",100.00,54718,47483,0,102201
"Khanpur","Uttarakhand",2251,950,0,3201,"836 ","120703 ",100.00,"120703 ",100.00,65733,54969,1,120703
"Manglore","Uttarakhand",1170,588,0,1758,"816 ","95912 ",100.00,"95912 ",100.00,52809,43102,1,95912
"Laksar","Uttarakhand",1604,648,0,2252,"828 ","86146 ",100.00,"86146 ",100.00,47125,39021,0,86146
"Hardwar Rural","Uttarakhand",1836,903,0,2739,"835 ","104829 ",100.00,"104829 ",100.00,57116,47713,0,104829
"Yamkeshwar","Uttarakhand",1128,693,0,1821,"912 ","79706 ",100.00,"79706 ",100.00,41691,38015,0,79706
"Pauri","Uttarakhand",938,642,0,1580,"1028 ","87920 ",100.00,"87920 ",100.00,43363,44557,0,87920
"Srinagar","Uttarakhand",1533,904,0,2437,"978 ","97032 ",100.00,"97032 ",100.00,49063,47969,0,97032
"Chaubattakhal","Uttarakhand",1020,626,0,1646,"1036 ","86222 ",100.00,"86222 ",100.00,42355,43867,0,86222
"Lansdowne","Uttarakhand",1170,618,0,1788,"959 ","76845 ",100.00,"76845 ",100.00,39220,37625,0,76845
"Kotdwar","Uttarakhand",1166,825,0,1991,"977 ","93275 ",100.00,"93275 ",100.00,47186,46089,0,93275
"Dharchula","Uttarakhand",1471,1019,0,2490,"1008 ","77247 ",100.00,"77247 ",100.00,38470,38777,0,77247
"Didihat","Uttarakhand",1232,817,0,2049,"1074 ","74681 ",100.00,"74681 ",100.00,36014,38667,0,74681
"Pithoragarh","Uttarakhand",1413,1031,0,2444,"1033 ","92897 ",100.00,"92897 ",100.00,45695,47202,0,92897
"Gangolihat","Uttarakhand",1600,891,0,2491,"945 ","91699 ",100.00,"91699 ",100.00,47135,44564,0,91699
"Kapkote","Uttarakhand",1606,909,0,2515,"986 ","88089 ",100.00,"88089 ",100.00,44365,43724,0,88089
"Bageshwar","Uttarakhand",1678,1018,0,2696,"967 ","103611 ",100.00,"103611 ",100.00,52683,50928,0,103611
"Dwarahat","Uttarakhand",1066,585,0,1651,"1063 ","87057 ",100.00,"87057 ",100.00,42207,44850,0,87057
"Salt","Uttarakhand",1178,594,0,1772,"987 ","90667 ",100.00,"90667 ",100.00,45623,45044,0,90667
"Ranikhet","Uttarakhand",1014,548,0,1562,"963 ","75745 ",100.00,"75745 ",100.00,38588,37157,0,75745
"Someshwar (s.c.)","Uttarakhand",1012,465,0,1477,"963 ","79534 ",100.00,"79534 ",100.00,40526,39008,0,79534
"Almora","Uttarakhand",999,523,0,1522,"931 ","81869 ",100.00,"81869 ",100.00,42406,39463,0,81869
"Jageshwar","Uttarakhand",1238,586,0,1824,"906 ","85810 ",100.00,"85810 ",100.00,45029,40781,0,85810
"Lohaghat","Uttarakhand",1847,933,0,2780,"909 ","96087 ",100.00,"96087 ",100.00,50338,45749,0,96087
"Champawat","Uttarakhand",1517,892,0,2409,"905 ","80670 ",100.00,"80670 ",100.00,42343,38327,0,80670
"Lalkuwa","Uttarakhand",1671,1022,0,2693,"875 ","98456 ",100.00,"98456 ",100.00,52498,45958,0,98456
"Bhimtal","Uttarakhand",1754,944,0,2698,"851 ","90673 ",100.00,"90673 ",100.00,48999,41674,0,90673
"Nainital","Uttarakhand",1372,834,0,2206,"877 ","100145 ",100.00,"100145 ",100.00,53361,46784,0,100145
"Haldwani","Uttarakhand",1909,1204,0,3113,"863 ","126504 ",100.00,"126504 ",100.00,67889,58615,0,126504
"Kaladhungi","Uttarakhand",1950,1305,0,3255,"923 ","129095 ",100.00,"129095 ",100.00,67135,61959,1,129095
"Ramnagar","Uttarakhand",954,559,0,1513,"891 ","97402 ",100.00,"97402 ",100.00,51497,45904,1,97402
"Jaspur","Uttarakhand",1954,1018,0,2972,"841 ","106794 ",100.00,"106794 ",100.00,58003,48791,0,106794
"Kashipur","Uttarakhand",1960,1163,0,3123,"878 ","126951 ",100.00,"126951 ",100.00,67596,59353,2,126951
"Bajpur","Uttarakhand",2002,1033,0,3035,"865 ","118487 ",100.00,"118487 ",100.00,63542,54945,0,118487
"Gadarpur","Uttarakhand",1696,814,0,2510,"881 ","109174 ",100.00,"109174 ",100.00,58032,51142,0,109174
"Rudrapur","Uttarakhand",1699,955,0,2654,"850 ","136713 ",100.00,"136713 ",100.00,73895,62818,0,136713
"Kichha","Uttarakhand",1351,738,0,2089,"847 ","104120 ",100.00,"104120 ",100.00,56371,47749,0,104120
"Sitarganj","Uttarakhand",1239,648,0,1887,"867 ","97569 ",100.00,"97569 ",100.00,52265,45304,0,97569
"Nanak matta","Uttarakhand",1420,863,0,2283,"922 ","97871 ",100.00,"97871 ",100.00,50913,46958,0,97871
"Khatima","Uttarakhand",1308,796,0,2104,"948 ","95243 ",100.00,"95243 ",100.00,48887,46356,0,95243
"Mekliganj","West Bengal",3883,2866,0,6749,"913 ","189953 ",100.00,"189953 ",100.00,99297,90653,3,189953
"Mathabhanga","West Bengal",4461,3192,0,7653,"900 ","216744 ",100.00,"216744 ",100.00,114104,102640,0,216744
"Cooch Behar Uttar","West Bengal",4962,3362,0,8324,"898 ","243455 ",100.00,"243455 ",100.00,128269,115184,2,243455
"Cooch Behar Dakshin","West Bengal",3341,2056,0,5397,"923 ","201229 ",100.00,"201229 ",100.00,104636,96592,1,201229
"Sitalkuchi","West Bengal",5323,3218,0,8541,"884 ","243607 ",100.00,"243607 ",100.00,129313,114293,1,243607
"Sitai","West Bengal",4725,2993,0,7718,"889 ","240841 ",100.00,"240841 ",100.00,127484,113357,0,240841
"Dinhata","West Bengal",4779,3340,0,8119,"907 ","250721 ",100.00,"250721 ",100.00,131459,119262,0,250721
"Natabari","West Bengal",3811,2743,0,6554,"919 ","212305 ",100.00,"212305 ",100.00,110644,101660,1,212305
"Tufanganj","West Bengal",3828,2711,0,6539,"906 ","202635 ",100.00,"202635 ",100.00,106338,96297,0,202635
"Kumargram","West Bengal",4962,3985,0,8947,"922 ","230791 ",100.00,"230791 ",100.00,120084,110707,0,230791
"Kalchini","West Bengal",4250,3913,0,8163,"981 ","205535 ",100.00,"205535 ",100.00,103773,101760,2,205535
"Alipurduars","West Bengal",4754,3656,1,8411,"925 ","224976 ",100.00,"224976 ",100.00,116867,108107,2,224976
"Falakata","West Bengal",4984,4169,0,9153,"926 ","216015 ",100.00,"216015 ",100.00,112186,103828,1,216015
"Madarihat","West Bengal",3880,3124,0,7004,"980 ","181240 ",100.00,"181240 ",100.00,91521,89709,10,181240
"Dhupguri","West Bengal",5194,4194,0,9388,"928 ","225459 ",100.00,"225459 ",100.00,116945,108513,1,225459
"Maynaguri","West Bengal",4799,3494,0,8293,"908 ","224441 ",100.00,"224441 ",100.00,117659,106782,0,224441
"Jalpaiguri","West Bengal",4502,3325,0,7827,"955 ","230278 ",100.00,"230278 ",100.00,117782,112493,3,230278
"Rajganj","West Bengal",5095,3872,0,8967,"922 ","204477 ",100.00,"204477 ",100.00,106404,98073,0,204477
"Dabgram-Fulbari","West Bengal",4594,3304,0,7898,"912 ","238876 ",100.00,"238876 ",100.00,124963,113912,1,238876
"Mal","West Bengal",4570,3638,0,8208,"934 ","211895 ",100.00,"211895 ",100.00,109562,102333,0,211895
"Nagrakata","West Bengal",3838,3406,0,7244,"1001 ","203617 ",100.00,"203617 ",100.00,101762,101854,1,203617
"Kalimpong","West Bengal",3037,2538,0,5575,"962 ","181892 ",100.00,"181892 ",100.00,92725,89167,0,181892
"Darjeeling","West Bengal",2882,2320,0,5202,"1006 ","220692 ",100.00,"220692 ",100.00,110039,110652,1,220692
"Kurseong","West Bengal",3514,2900,0,6414,"1019 ","209081 ",100.00,"209081 ",100.00,103535,105546,0,209081
"Matigara-naxalbari","West Bengal",4326,3494,0,7820,"963 ","222997 ",100.00,"222997 ",100.00,113581,109415,1,222997
"Siliguri","West Bengal",2715,1900,0,4615,"919 ","196542 ",100.00,"196542 ",100.00,102419,94123,0,196542
"Phansidewa","West Bengal",4480,3486,0,7966,"930 ","190367 ",100.00,"190367 ",100.00,98656,91709,2,190367
"Chopra","West Bengal",4668,3572,9,8249,"895 ","193597 ",100.00,"193597 ",100.00,102177,91403,17,193597
"Islampur","West Bengal",4451,3285,0,7736,"890 ","177206 ",100.00,"177206 ",100.00,93746,83459,1,177206
"Goalpokhar","West Bengal",3037,2655,0,5692,"941 ","188560 ",100.00,"188560 ",100.00,97149,91407,4,188560
"Chakulia","West Bengal",4526,3703,0,8229,"940 ","190137 ",100.00,"190137 ",100.00,98005,92129,3,190137
"Karandighi","West Bengal",5474,4273,0,9747,"924 ","214341 ",100.00,"214341 ",100.00,111425,102909,7,214341
"Hemtabad","West Bengal",5077,4096,0,9173,"892 ","214517 ",100.00,"214517 ",100.00,113403,101112,2,214517
"Kaliaganj","West Bengal",5549,4349,0,9898,"907 ","232714 ",100.00,"232714 ",100.00,121999,110709,6,232714
"Raiganj","West Bengal",3011,2371,1,5383,"931 ","165806 ",100.00,"165806 ",100.00,85854,79941,11,165806
"Itahar","West Bengal",4870,4028,0,8898,"914 ","188972 ",100.00,"188972 ",100.00,98719,90251,2,188972
"Kushmandi","West Bengal",4133,3053,0,7186,"899 ","179557 ",100.00,"179557 ",100.00,94533,85024,0,179557
"Kumarganj","West Bengal",4032,3307,0,7339,"909 ","170653 ",100.00,"170653 ",100.00,89384,81267,2,170653
"Balurghat","West Bengal",3143,2338,0,5481,"952 ","155915 ",100.00,"155915 ",100.00,79873,76042,0,155915
"Tapan","West Bengal",3588,3088,0,6676,"928 ","181103 ",100.00,"181103 ",100.00,93909,87193,1,181103
"Gangarampur","West Bengal",4193,3212,0,7405,"915 ","186444 ",100.00,"186444 ",100.00,97352,89088,4,186444
"Harirampur","West Bengal",4082,3375,1,7458,"927 ","186809 ",100.00,"186809 ",100.00,96928,89880,1,186809
"Habibpur","West Bengal",4668,3676,1,8345,"948 ","211226 ",100.00,"211226 ",100.00,108425,102800,1,211226
"Gazole","West Bengal",6137,4841,0,10978,"954 ","216240 ",100.00,"216240 ",100.00,110639,105600,1,216240
"Chanchal","West Bengal",5035,3968,2,9005,"912 ","202927 ",100.00,"202927 ",100.00,106145,96779,3,202927
"Harischandrapur","West Bengal",5296,4296,0,9592,"899 ","194322 ",100.00,"194322 ",100.00,102309,92011,2,194322
"Malatipur","West Bengal",3760,3827,0,7587,"921 ","177657 ",100.00,"177657 ",100.00,92481,85173,3,177657
"Ratua","West Bengal",4808,4182,0,8990,"916 ","221392 ",100.00,"221392 ",100.00,115572,105815,5,221392
"Manickchak","West Bengal",5392,3734,0,9126,"891 ","202199 ",100.00,"202199 ",100.00,106900,95298,1,202199
"Maldaha","West Bengal",4897,3710,0,8607,"927 ","197068 ",100.00,"197068 ",100.00,102257,94808,3,197068
"Englishbazar","West Bengal",4406,3187,0,7593,"952 ","231589 ",100.00,"231589 ",100.00,118621,112968,0,231589
"Mothabari","West Bengal",4098,3435,0,7533,"944 ","154379 ",100.00,"154379 ",100.00,79400,74978,1,154379
"Sujapur","West Bengal",4916,3946,2,8864,"926 ","198544 ",100.00,"198544 ",100.00,103098,95443,3,198544
"Baishnabnagar","West Bengal",5794,4501,1,10296,"941 ","196588 ",100.00,"196588 ",100.00,101260,95320,8,196588
"Farakka","West Bengal",5100,4196,0,9296,"965 ","178623 ",100.00,"178623 ",100.00,90882,87741,0,178623
"Samserganj","West Bengal",5351,4672,0,10023,"1016 ","181929 ",100.00,"181929 ",100.00,90242,91686,1,181929
"Suti","West Bengal",5612,4704,1,10317,"983 ","207267 ",100.00,"207267 ",100.00,104538,102723,6,207267
"Jangipur","West Bengal",4935,3680,0,8615,"933 ","199966 ",100.00,"199966 ",100.00,103460,96506,0,199966
"Raghunathganj","West Bengal",5218,4030,0,9248,"938 ","194433 ",100.00,"194433 ",100.00,100343,94089,1,194433
"Sagardighi","West Bengal",5376,4468,0,9844,"957 ","193372 ",100.00,"193372 ",100.00,98801,94568,3,193372
"Lalgola","West Bengal",5150,4681,0,9831,"946 ","186781 ",100.00,"186781 ",100.00,95977,90803,1,186781
"Bhagawangola","West Bengal",5419,4860,0,10279,"933 ","209013 ",100.00,"209013 ",100.00,108152,100861,0,209013
"Raninagar","West Bengal",6074,5003,0,11077,"937 ","213901 ",100.00,"213901 ",100.00,110409,103492,0,213901
"Murshidabad","West Bengal",5424,4347,0,9771,"937 ","220325 ",100.00,"220325 ",100.00,113719,106606,0,220325
"Nabagram","West Bengal",5678,4339,0,10017,"944 ","210632 ",100.00,"210632 ",100.00,108353,102278,1,210632
"Khargram","West Bengal",4725,3701,0,8426,"936 ","194809 ",100.00,"194809 ",100.00,100620,94188,1,194809
"Burwan","West Bengal",4231,3111,0,7342,"917 ","185099 ",100.00,"185099 ",100.00,96568,88529,2,185099
"Kandi","West Bengal",4216,3304,0,7520,"937 ","196804 ",100.00,"196804 ",100.00,101627,95177,0,196804
"Bharatpur","West Bengal",5388,3671,0,9059,"926 ","204354 ",100.00,"204354 ",100.00,106106,98246,2,204354
"Rejinagar","West Bengal",5827,4775,0,10602,"914 ","213731 ",100.00,"213731 ",100.00,111650,102079,2,213731
"Beldanga","West Bengal",5535,4437,0,9972,"925 ","207248 ",100.00,"207248 ",100.00,107664,99583,1,207248
"Baharampur","West Bengal",3692,3069,0,6761,"993 ","227596 ",100.00,"227596 ",100.00,114225,113370,1,227596
"Hariharpara","West Bengal",5261,4374,0,9635,"939 ","207451 ",100.00,"207451 ",100.00,106962,100489,0,207451
"Nowda","West Bengal",5352,4371,0,9723,"925 ","208369 ",100.00,"208369 ",100.00,108223,100145,1,208369
"Domkal","West Bengal",6420,5561,0,11981,"934 ","221794 ",100.00,"221794 ",100.00,114702,107092,0,221794
"Jalangi","West Bengal",6243,4982,0,11225,"935 ","216829 ",100.00,"216829 ",100.00,112076,104753,0,216829
"Karimpur","West Bengal",5146,4504,0,9650,"928 ","218407 ",100.00,"218407 ",100.00,113269,105137,1,218407
"Tehatta","West Bengal",4988,3948,0,8936,"915 ","220387 ",100.00,"220387 ",100.00,115098,105287,2,220387
"Palashipara","West Bengal",4969,3794,1,8764,"905 ","208199 ",100.00,"208199 ",100.00,109282,98915,2,208199
"Kaliganj","West Bengal",4803,3732,0,8535,"916 ","209298 ",100.00,"209298 ",100.00,109234,100064,0,209298
"Nakashipara","West Bengal",4274,3253,0,7527,"913 ","213267 ",100.00,"213267 ",100.00,111463,101803,1,213267
"Chapra","West Bengal",4965,3696,0,8661,"911 ","207343 ",100.00,"207343 ",100.00,108499,98844,0,207343
"Krishnanagar Uttar","West Bengal",3205,2606,0,5811,"962 ","214465 ",100.00,"214465 ",100.00,109297,105163,5,214465
"Nabadwip","West Bengal",3842,2853,0,6695,"940 ","218338 ",100.00,"218338 ",100.00,112548,105789,1,218338
"Krishnanagar Dakshin","West Bengal",4065,3034,0,7099,"922 ","194219 ",100.00,"194219 ",100.00,101045,93172,2,194219
"Santipur","West Bengal",3614,2576,0,6190,"921 ","213967 ",100.00,"213967 ",100.00,111399,102566,2,213967
"Ranaghat Uttar paschim","West Bengal",4026,3203,0,7229,"958 ","233218 ",100.00,"233218 ",100.00,119131,114082,5,233218
"Krishnaganj","West Bengal",5009,3575,0,8584,"915 ","238130 ",100.00,"238130 ",100.00,124358,113770,2,238130
"Ranaghat Uttar Purba","West Bengal",4446,3536,0,7982,"907 ","225121 ",100.00,"225121 ",100.00,118071,107045,5,225121
"Ranaghat Dakshin","West Bengal",4948,3931,0,8879,"944 ","244968 ",100.00,"244968 ",100.00,126029,118937,2,244968
"Chakdaha","West Bengal",3594,2584,0,6178,"934 ","216412 ",100.00,"216412 ",100.00,111888,104524,0,216412
"Kalyani","West Bengal",3231,2398,0,5629,"935 ","220679 ",100.00,"220679 ",100.00,114065,106614,0,220679
"Haringhata","West Bengal",4177,3211,0,7388,"914 ","209402 ",100.00,"209402 ",100.00,109411,99991,0,209402
"Bagdah","West Bengal",4011,3160,0,7171,"914 ","238688 ",100.00,"238688 ",100.00,124718,113970,0,238688
"Bongaon Uttar","West Bengal",4028,3273,0,7301,"953 ","217245 ",100.00,"217245 ",100.00,111263,105979,3,217245
"Bongaon Dakshin","West Bengal",3968,3280,0,7248,"956 ","212745 ",100.00,"212745 ",100.00,108761,103981,3,212745
"Gaighata","West Bengal",3395,2765,0,6160,"971 ","209655 ",100.00,"209655 ",100.00,106384,103271,0,209655
"Swarupnagar","West Bengal",3865,2946,0,6811,"933 ","215331 ",100.00,"215331 ",100.00,111425,103904,2,215331
"Baduria","West Bengal",4368,3361,0,7729,"944 ","210736 ",100.00,"210736 ",100.00,108390,102346,0,210736
"Habra","West Bengal",2844,2168,0,5012,"955 ","205282 ",100.00,"205282 ",100.00,105022,100258,2,205282
"Ashoknagar","West Bengal",3619,2877,1,6497,"976 ","217437 ",100.00,"217437 ",100.00,110056,107377,4,217437
"Amdanga","West Bengal",4217,2943,0,7160,"919 ","204995 ",100.00,"204995 ",100.00,106807,98187,1,204995
"Bijpur","West Bengal",2148,1542,0,3690,"886 ","168435 ",100.00,"168435 ",100.00,89299,79135,1,168435
"Naihati","West Bengal",2240,1744,0,3984,"928 ","166888 ",100.00,"166888 ",100.00,86578,80310,0,166888
"Bhatpara","West Bengal",2128,1410,0,3538,"738 ","131885 ",100.00,"131885 ",100.00,75899,55986,0,131885
"Jagatdal","West Bengal",2624,1904,0,4528,"890 ","190361 ",100.00,"190361 ",100.00,100711,89649,1,190361
"Noapara","West Bengal",2429,1945,1,4375,"941 ","225950 ",100.00,"225950 ",100.00,116416,109532,2,225950
"Barrackpur","West Bengal",2104,1607,0,3711,"861 ","186124 ",100.00,"186124 ",100.00,100038,86086,0,186124
"Khardaha","West Bengal",2237,1748,0,3985,"943 ","187944 ",100.00,"187944 ",100.00,96739,91200,5,187944
"Dum Dum Uttar","West Bengal",2570,2088,0,4658,"965 ","222059 ",100.00,"222059 ",100.00,112984,109075,0,222059
"Panihati","West Bengal",1881,1508,0,3389,"961 ","197278 ",100.00,"197278 ",100.00,100582,96695,1,197278
"Kamarhati","West Bengal",1988,1555,0,3543,"914 ","171477 ",100.00,"171477 ",100.00,89580,81896,1,171477
"Baranagar","West Bengal",1795,1550,0,3345,"982 ","194601 ",100.00,"194601 ",100.00,98166,96435,0,194601
"Dum dum","West Bengal",2157,1888,0,4045,"976 ","203659 ",100.00,"203659 ",100.00,103087,100570,2,203659
"Rajarhat new town","West Bengal",3625,2612,1,6238,"925 ","211999 ",100.00,"211999 ",100.00,110107,101888,4,211999
"Bidhannagar","West Bengal",1934,1642,0,3576,"998 ","207745 ",100.00,"207745 ",100.00,103999,103743,3,207745
"Rajarhat gopalpur","West Bengal",2171,1751,0,3922,"993 ","209777 ",100.00,"209777 ",100.00,105240,104537,0,209777
"Madhyamgram","West Bengal",3411,2601,0,6012,"940 ","220305 ",100.00,"220305 ",100.00,113585,106717,3,220305
"Barasat","West Bengal",2944,2368,0,5312,"979 ","232967 ",100.00,"232967 ",100.00,117746,115218,3,232967
"Deganga","West Bengal",4924,3562,1,8487,"914 ","204357 ",100.00,"204357 ",100.00,106793,97562,2,204357
"Haroa","West Bengal",5026,3063,0,8089,"878 ","217045 ",100.00,"217045 ",100.00,115542,101500,3,217045
"Minakhan","West Bengal",4820,3113,0,7933,"887 ","192733 ",100.00,"192733 ",100.00,102134,90596,3,192733
"Sandeshkhali","West Bengal",4952,4130,0,9082,"919 ","202330 ",100.00,"202330 ",100.00,105433,96896,1,202330
"Basirhat Dakshin","West Bengal",4523,3154,0,7677,"948 ","234884 ",100.00,"234884 ",100.00,120552,114327,5,234884
"Basirhat Uttar","West Bengal",5581,4154,0,9735,"915 ","225061 ",100.00,"225061 ",100.00,117548,107510,3,225061
"Hingalganj","West Bengal",3839,3119,0,6958,"931 ","203479 ",100.00,"203479 ",100.00,105351,98126,2,203479
"Gosaba","West Bengal",3879,2772,0,6651,"924 ","204248 ",100.00,"204248 ",100.00,106154,98089,5,204248
"Basanti (S.C.)","West Bengal",4343,3239,0,7582,"927 ","212440 ",100.00,"212440 ",100.00,110259,102167,14,212440
"Kultali (S.C)","West Bengal",3773,3219,0,6992,"924 ","216620 ",100.00,"216620 ",100.00,112591,104025,4,216620
"Patharpratima","West Bengal",5984,4866,0,10850,"926 ","226748 ",100.00,"226748 ",100.00,117753,108994,1,226748
"Kakdwip","West Bengal",5001,3756,0,8757,"926 ","205524 ",100.00,"205524 ",100.00,106693,98829,2,205524
"Sagar","West Bengal",6167,4442,0,10609,"912 ","231619 ",100.00,"231619 ",100.00,121134,110482,3,231619
"Kulpi","West Bengal",3686,2926,0,6612,"937 ","189433 ",100.00,"189433 ",100.00,97812,91620,1,189433
"Raidighi","West Bengal",5126,3973,0,9099,"926 ","234346 ",100.00,"234346 ",100.00,121700,112645,1,234346
"Mandirbazar","West Bengal",3985,3113,0,7098,"941 ","202307 ",100.00,"202307 ",100.00,104247,98060,0,202307
"Jaynagar","West Bengal",3693,2820,0,6513,"923 ","202275 ",100.00,"202275 ",100.00,105212,97063,0,202275
"Baruipur Purba","West Bengal",4286,2675,0,6961,"933 ","213777 ",100.00,"213777 ",100.00,110612,103159,6,213777
"Canning paschim","West Bengal",4147,2946,0,7093,"945 ","208945 ",100.00,"208945 ",100.00,107412,101532,1,208945
"Canning Purba","West Bengal",4248,2438,0,6686,"894 ","201487 ",100.00,"201487 ",100.00,106400,95075,12,201487
"Baruipur paschim","West Bengal",3372,2460,0,5832,"949 ","203396 ",100.00,"203396 ",100.00,104333,99058,5,203396
"Magrahat Purba","West Bengal",4456,3389,0,7845,"915 ","207637 ",100.00,"207637 ",100.00,108446,99191,0,207637
"Magrahat paschim","West Bengal",4290,3116,0,7406,"916 ","195515 ",100.00,"195515 ",100.00,102031,93484,0,195515
"Diamond harbour","West Bengal",3990,2966,0,6956,"935 ","220750 ",100.00,"220750 ",100.00,114076,106672,2,220750
"Falta","West Bengal",4216,2700,0,6916,"911 ","204637 ",100.00,"204637 ",100.00,107088,97547,2,204637
"Satgachia","West Bengal",4059,2724,0,6783,"920 ","235801 ",100.00,"235801 ",100.00,122827,112966,8,235801
"Bishnupur","West Bengal",3867,2564,3,6434,"913 ","234833 ",100.00,"234833 ",100.00,122784,112041,8,234833
"Sonarpur Dakshin","West Bengal",2956,2217,0,5173,"966 ","228577 ",100.00,"228577 ",100.00,116250,112326,1,228577
"Bhangore","West Bengal",4959,2680,2,7641,"875 ","214597 ",100.00,"214597 ",100.00,114423,100159,15,214597
"Kasba","West Bengal",2888,2061,0,4949,"931 ","247909 ",100.00,"247909 ",100.00,128413,119494,2,247909
"Jadavpur","West Bengal",1889,1665,0,3554,"1035 ","261165 ",100.00,"261165 ",100.00,128318,132847,0,261165
"Sonarpur Uttar","West Bengal",2906,2070,0,4976,"944 ","220053 ",100.00,"220053 ",100.00,113213,106835,5,220053
"Tollygunj","West Bengal",1578,1219,0,2797,"1018 ","237412 ",100.00,"237412 ",100.00,117621,119790,1,237412
"BEHALA PURBA","West Bengal",2173,1702,0,3875,"1002 ","261176 ",100.00,"261176 ",100.00,130427,130747,2,261176
"Behala paschim","West Bengal",2329,1969,0,4298,"1007 ","278261 ",100.00,"278261 ",100.00,138629,139631,1,278261
"Maheshtala","West Bengal",2908,1945,0,4853,"936 ","228615 ",100.00,"228615 ",100.00,118056,110557,2,228615
"BUDGE BUDGE","West Bengal",3176,2045,1,5222,"906 ","221675 ",100.00,"221675 ",100.00,116314,105358,3,221675
"Metiaburuz","West Bengal",3192,1721,0,4913,"801 ","204219 ",100.00,"204219 ",100.00,113416,90803,0,204219
"Kolkata port","West Bengal",2938,1709,0,4647,"725 ","216714 ",100.00,"216714 ",100.00,125641,91073,0,216714
"Bhabanipur","West Bengal",1848,1263,0,3111,"798 ","211538 ",100.00,"211538 ",100.00,117626,93912,0,211538
"Rashbehari","West Bengal",1461,1091,0,2552,"957 ","204646 ",100.00,"204646 ",100.00,104568,100076,2,204646
"Ballygunge","West Bengal",2525,1759,0,4284,"815 ","243062 ",100.00,"243062 ",100.00,133935,109125,2,243062
"Chowrangee","West Bengal",1758,1165,0,2923,"626 ","195769 ",100.00,"195769 ",100.00,120424,75343,2,195769
"Entally","West Bengal",2181,1444,1,3626,"827 ","192463 ",100.00,"192463 ",100.00,105349,87112,2,192463
"Beleghata","West Bengal",2181,1563,0,3744,"860 ","234666 ",100.00,"234666 ",100.00,126161,108504,1,234666
"Jorasanko","West Bengal",1326,860,0,2186,"680 ","191525 ",100.00,"191525 ",100.00,114023,77501,1,191525
"Shyampukur","West Bengal",1320,1041,0,2361,"844 ","177721 ",100.00,"177721 ",100.00,96388,81333,0,177721
"Maniktala","West Bengal",1860,1333,0,3193,"890 ","209192 ",100.00,"209192 ",100.00,110665,98527,0,209192
"Kashipur-Belgachia","West Bengal",2208,1509,1,3718,"864 ","215274 ",100.00,"215274 ",100.00,115492,99781,1,215274
"Bally","West Bengal",1828,1258,0,3086,"821 ","151878 ",100.00,"151878 ",100.00,83389,68487,2,151878
"Howrah Uttar","West Bengal",2296,1421,0,3717,"768 ","184449 ",100.00,"184449 ",100.00,104331,80118,0,184449
"Howrah madhya","West Bengal",2892,2049,0,4941,"845 ","236239 ",100.00,"236239 ",100.00,128015,108224,0,236239
"Shibpur","West Bengal",2206,1607,0,3813,"933 ","207765 ",100.00,"207765 ",100.00,107500,100265,0,207765
"Howrah Dakshin","West Bengal",2752,2020,0,4772,"903 ","246625 ",100.00,"246625 ",100.00,129609,117016,0,246625
"Sankrail","West Bengal",3520,2281,0,5801,"902 ","232908 ",100.00,"232908 ",100.00,122472,110434,2,232908
"Panchla","West Bengal",4394,3151,0,7545,"922 ","233004 ",100.00,"233004 ",100.00,121252,111752,0,233004
"Uluberia Purba","West Bengal",2768,1654,0,4422,"880 ","193460 ",100.00,"193460 ",100.00,102892,90568,0,193460
"Uluberia Uttar","West Bengal",3643,2273,0,5916,"896 ","190640 ",100.00,"190640 ",100.00,100566,90072,2,190640
"Uluberia Dakshin","West Bengal",4012,2537,0,6549,"905 ","196353 ",100.00,"196353 ",100.00,103091,93262,0,196353
"Shyampur","West Bengal",5118,3851,0,8969,"934 ","229070 ",100.00,"229070 ",100.00,118439,110631,0,229070
"Bagnan","West Bengal",4203,2931,0,7134,"915 ","201633 ",100.00,"201633 ",100.00,105297,96336,0,201633
"Amta","West Bengal",3976,2564,0,6540,"887 ","226960 ",100.00,"226960 ",100.00,120266,106693,1,226960
"Udaynarayanpur","West Bengal",3360,2181,0,5541,"887 ","206652 ",100.00,"206652 ",100.00,109500,97152,0,206652
"Jagatballavpur","West Bengal",4256,2755,0,7011,"918 ","249231 ",100.00,"249231 ",100.00,129971,119260,0,249231
"Domjur","West Bengal",3696,2771,0,6467,"920 ","244983 ",100.00,"244983 ",100.00,127615,117366,2,244983
"Uttarpara","West Bengal",2594,1985,0,4579,"972 ","229758 ",100.00,"229758 ",100.00,116503,113252,3,229758
"Sreerampur","West Bengal",2544,1732,0,4276,"859 ","216158 ",100.00,"216158 ",100.00,116269,99889,0,216158
"Champdani","West Bengal",2536,1718,0,4254,"911 ","222047 ",100.00,"222047 ",100.00,116186,105858,3,222047
"Singur","West Bengal",3418,2615,0,6033,"928 ","223701 ",100.00,"223701 ",100.00,116050,107650,1,223701
"Chandannagore","West Bengal",2135,1823,0,3958,"940 ","203925 ",100.00,"203925 ",100.00,105131,98792,2,203925
"Chunchura","West Bengal",3174,2366,0,5540,"977 ","285206 ",100.00,"285206 ",100.00,144259,140943,4,285206
"Balagarh","West Bengal",3049,2292,0,5341,"928 ","228582 ",100.00,"228582 ",100.00,118570,110010,2,228582
"Pandua","West Bengal",3513,2568,0,6081,"963 ","232270 ",100.00,"232270 ",100.00,118339,113930,1,232270
"Saptagram","West Bengal",2757,1953,0,4710,"929 ","206298 ",100.00,"206298 ",100.00,106951,99347,0,206298
"Chanditala","West Bengal",4076,2959,0,7035,"917 ","226498 ",100.00,"226498 ",100.00,118172,108323,3,226498
"Jangipara","West Bengal",4539,3015,0,7554,"912 ","224443 ",100.00,"224443 ",100.00,117386,107055,2,224443
"Haripal","West Bengal",4306,3316,1,7623,"921 ","237815 ",100.00,"237815 ",100.00,123767,114044,4,237815
"Dhanekhali","West Bengal",3526,2650,0,6176,"973 ","241929 ",100.00,"241929 ",100.00,122642,119285,2,241929
"Tarakeswar","West Bengal",3178,2356,0,5534,"940 ","215039 ",100.00,"215039 ",100.00,110825,104212,2,215039
"Pursurah","West Bengal",3354,2201,0,5555,"913 ","229766 ",100.00,"229766 ",100.00,120100,109666,0,229766
"Arambagh","West Bengal",3537,2537,0,6074,"938 ","222773 ",100.00,"222773 ",100.00,114958,107814,1,222773
"Goghat","West Bengal",4876,3620,0,8496,"932 ","213662 ",100.00,"213662 ",100.00,110580,103082,0,213662
"Khanakul","West Bengal",3746,2811,0,6557,"893 ","239373 ",100.00,"239373 ",100.00,126474,112898,1,239373
"Tamluk","West Bengal",4723,3542,0,8265,"920 ","233149 ",100.00,"233149 ",100.00,121411,111735,3,233149
"Panskura Purba","West Bengal",4443,3507,0,7950,"914 ","207244 ",100.00,"207244 ",100.00,108300,98943,1,207244
"Panskura paschim","West Bengal",5378,3937,0,9315,"914 ","234352 ",100.00,"234352 ",100.00,122438,111902,12,234352
"Moyna","West Bengal",4749,3747,2,8498,"916 ","218597 ",100.00,"218597 ",100.00,114075,104519,3,218597
"Nandakumar","West Bengal",5537,3808,1,9346,"909 ","217512 ",100.00,"217512 ",100.00,113937,103570,5,217512
"Mahisadal","West Bengal",5165,3943,0,9108,"930 ","212668 ",100.00,"212668 ",100.00,110171,102497,0,212668
"Haldia","West Bengal",4834,3383,0,8217,"914 ","213405 ",100.00,"213405 ",100.00,111478,101927,0,213405
"Nandigram","West Bengal",5375,3668,0,9043,"924 ","218216 ",100.00,"218216 ",100.00,113436,104780,0,218216
"Chandipur","West Bengal",5121,4034,0,9155,"916 ","211133 ",100.00,"211133 ",100.00,110182,100951,0,211133
"Patashpur","West Bengal",4674,3262,0,7936,"904 ","200774 ",100.00,"200774 ",100.00,105434,95339,1,200774
"Kanthi Uttar","West Bengal",4933,3609,0,8542,"912 ","225195 ",100.00,"225195 ",100.00,117805,107390,0,225195
"Bhagabanpur","West Bengal",5416,3746,0,9162,"913 ","220056 ",100.00,"220056 ",100.00,115039,105015,2,220056
"Khejuri","West Bengal",5265,4050,0,9315,"926 ","202361 ",100.00,"202361 ",100.00,105087,97274,0,202361
"Kanthi Dakshin","West Bengal",4043,3064,1,7108,"933 ","194828 ",100.00,"194828 ",100.00,100793,94033,2,194828
"Ramnagar","West Bengal",4593,3537,0,8130,"934 ","228259 ",100.00,"228259 ",100.00,118044,110215,0,228259
"Egra","West Bengal",5656,4278,0,9934,"912 ","247562 ",100.00,"247562 ",100.00,129473,118087,2,247562
"Dantan","West Bengal",5012,3331,0,8343,"909 ","198629 ",100.00,"198629 ",100.00,104041,94588,0,198629
"Nayagram","West Bengal",4090,3121,0,7211,"949 ","196142 ",100.00,"196142 ",100.00,100637,95505,0,196142
"Gopiballavpur","West Bengal",4264,3227,0,7491,"967 ","198166 ",100.00,"198166 ",100.00,100746,97420,0,198166
"Jhargram","West Bengal",3790,3180,0,6970,"974 ","205018 ",100.00,"205018 ",100.00,103842,101176,0,205018
"Keshiary","West Bengal",4860,3521,0,8381,"948 ","204919 ",100.00,"204919 ",100.00,105214,99704,1,204919
"Kharagpur sadar","West Bengal",2499,1826,0,4325,"975 ","204194 ",100.00,"204194 ",100.00,103393,100800,1,204194
"Narayangarh","West Bengal",4512,3229,0,7741,"965 ","209929 ",100.00,"209929 ",100.00,106858,103070,1,209929
"SABANG","West Bengal",5180,3727,0,8907,"928 ","227065 ",100.00,"227065 ",100.00,117803,109262,0,227065
"Pingla","West Bengal",4998,3427,0,8425,"942 ","216113 ",100.00,"216113 ",100.00,111297,104816,0,216113
"Kharagpur","West Bengal",4101,2820,0,6921,"949 ","187858 ",100.00,"187858 ",100.00,96388,91469,1,187858
"Debra","West Bengal",3872,3042,0,6914,"962 ","201883 ",100.00,"201883 ",100.00,102909,98974,0,201883
"Daspur","West Bengal",4930,4220,0,9150,"932 ","263978 ",100.00,"263978 ",100.00,136644,127332,2,263978
"Ghatal","West Bengal",4495,3543,0,8038,"919 ","241935 ",100.00,"241935 ",100.00,126063,115872,0,241935
"Chandrakona","West Bengal",5077,4019,0,9096,"921 ","237136 ",100.00,"237136 ",100.00,123467,113668,1,237136
"Garbeta","West Bengal",4441,2981,0,7422,"925 ","194292 ",100.00,"194292 ",100.00,100929,93363,0,194292
"Salboni","West Bengal",5734,4304,0,10038,"948 ","233623 ",100.00,"233623 ",100.00,119905,113718,0,233623
"Keshpur","West Bengal",5543,3293,0,8836,"907 ","218428 ",100.00,"218428 ",100.00,114552,103874,2,218428
"Medinipur","West Bengal",4134,3272,0,7406,"976 ","239664 ",100.00,"239664 ",100.00,121260,118404,0,239664
"Binpur","West Bengal",4346,3504,0,7850,"980 ","197879 ",100.00,"197879 ",100.00,99959,97919,1,197879
"Bandwan","West Bengal",5123,3901,0,9024,"961 ","246561 ",100.00,"246561 ",100.00,125730,120831,0,246561
"Balarampur","West Bengal",3991,2695,0,6686,"901 ","198018 ",100.00,"198018 ",100.00,104142,93876,0,198018
"Baghmundi","West Bengal",3906,3052,0,6958,"936 ","214190 ",100.00,"214190 ",100.00,110628,103561,1,214190
"Joypur","West Bengal",3475,2525,0,6000,"934 ","208700 ",100.00,"208700 ",100.00,107912,100788,0,208700
"Purulia","West Bengal",4116,2801,1,6918,"913 ","214389 ",100.00,"214389 ",100.00,112089,102299,1,214389
"Manbazar","West Bengal",4816,3506,1,8323,"955 ","220352 ",100.00,"220352 ",100.00,112692,107659,1,220352
"Kashipur","West Bengal",3819,2936,0,6755,"943 ","206540 ",100.00,"206540 ",100.00,106315,100225,0,206540
"Para","West Bengal",4763,2651,0,7414,"886 ","204494 ",100.00,"204494 ",100.00,108421,96073,0,204494
"Raghunathpur","West Bengal",4285,2848,0,7133,"900 ","222146 ",100.00,"222146 ",100.00,116943,105203,0,222146
"Saltora","West Bengal",4284,2665,0,6949,"926 ","206901 ",100.00,"206901 ",100.00,107403,99496,2,206901
"Chhatna","West Bengal",4409,2975,0,7384,"936 ","212473 ",100.00,"212473 ",100.00,109729,102743,1,212473
"Ranibandh","West Bengal",4079,3004,0,7083,"952 ","221680 ",100.00,"221680 ",100.00,113541,108139,0,221680
"Raipur","West Bengal",4128,3300,0,7428,"965 ","197883 ",100.00,"197883 ",100.00,100703,97180,0,197883
"Taldangra","West Bengal",3734,2619,0,6353,"934 ","201426 ",100.00,"201426 ",100.00,104169,97257,0,201426
"Bankura","West Bengal",3754,2710,1,6465,"956 ","235830 ",100.00,"235830 ",100.00,120572,115253,5,235830
"Barjora","West Bengal",4686,3260,0,7946,"943 ","222713 ",100.00,"222713 ",100.00,114624,108087,2,222713
"Onda","West Bengal",3706,2378,0,6084,"928 ","218143 ",100.00,"218143 ",100.00,113116,105027,0,218143
"Bishnupur","West Bengal",3742,2720,1,6463,"949 ","187142 ",100.00,"187142 ",100.00,95995,91144,3,187142
"Kotulpur","West Bengal",5245,3683,0,8928,"929 ","211370 ",100.00,"211370 ",100.00,109566,101804,0,211370
"Indas","West Bengal",4755,3295,0,8050,"929 ","209315 ",100.00,"209315 ",100.00,108519,100794,2,209315
"Sonamukhi","West Bengal",4522,2973,0,7495,"920 ","202280 ",100.00,"202280 ",100.00,105347,96931,2,202280
"Khandaghosh","West Bengal",4418,2920,0,7338,"932 ","211087 ",100.00,"211087 ",100.00,109281,101804,2,211087
"Bardhaman Dakshin","West Bengal",2649,2128,0,4777,"960 ","232329 ",100.00,"232329 ",100.00,118554,113772,3,232329
"Raina","West Bengal",4875,3267,0,8142,"931 ","225972 ",100.00,"225972 ",100.00,117037,108935,0,225972
"Jamalpur","West Bengal",3857,2800,0,6657,"940 ","208807 ",100.00,"208807 ",100.00,107621,101179,7,208807
"Monteswar","West Bengal",4664,3257,0,7921,"933 ","210064 ",100.00,"210064 ",100.00,108659,101405,0,210064
"Kalna","West Bengal",3860,2749,1,6610,"929 ","208512 ",100.00,"208512 ",100.00,108085,100426,1,208512
"Memari","West Bengal",3449,2781,0,6230,"956 ","222375 ",100.00,"222375 ",100.00,113685,108688,2,222375
"Bardhaman Uttar","West Bengal",3762,2495,0,6257,"960 ","233389 ",100.00,"233389 ",100.00,119085,114302,2,233389
"Bhatar","West Bengal",3905,2629,0,6534,"942 ","217839 ",100.00,"217839 ",100.00,112151,105686,2,217839
"Purbasthali Dakshin","West Bengal",4497,3060,0,7557,"919 ","214585 ",100.00,"214585 ",100.00,111809,102776,0,214585
"Purbasthali Uttar","West Bengal",4287,2921,0,7208,"893 ","213904 ",100.00,"213904 ",100.00,112995,100908,1,213904
"Katwa","West Bengal",4451,2981,0,7432,"924 ","231110 ",100.00,"231110 ",100.00,120114,110996,0,231110
"Ketugram","West Bengal",4220,2554,0,6774,"892 ","219282 ",100.00,"219282 ",100.00,115891,103391,0,219282
"Mangalkot","West Bengal",3671,2403,0,6074,"917 ","219450 ",100.00,"219450 ",100.00,114472,104977,1,219450
"Ausgram","West Bengal",3995,2613,0,6608,"934 ","214032 ",100.00,"214032 ",100.00,110683,103346,3,214032
"Galsi","West Bengal",3913,2675,0,6588,"923 ","224798 ",100.00,"224798 ",100.00,116892,107906,0,224798
"Pandabeswar","West Bengal",2728,1605,0,4333,"847 ","183729 ",100.00,"183729 ",100.00,99489,84240,0,183729
"Durgapur Purba","West Bengal",2563,1798,0,4361,"915 ","222866 ",100.00,"222866 ",100.00,116409,106457,0,222866
"Durgapur paschim","West Bengal",2769,1701,0,4470,"862 ","231968 ",100.00,"231968 ",100.00,124578,107388,2,231968
"Raniganj","West Bengal",3290,2220,0,5510,"851 ","217332 ",100.00,"217332 ",100.00,117404,99928,0,217332
"Jamuria","West Bengal",3418,2136,0,5554,"830 ","190017 ",100.00,"190017 ",100.00,103807,86209,1,190017
"Asansol Dakshin","West Bengal",3692,2362,0,6054,"843 ","229755 ",100.00,"229755 ",100.00,124651,105102,2,229755
"Asansol Uttar","West Bengal",3401,2531,0,5932,"884 ","223402 ",100.00,"223402 ",100.00,118548,104842,12,223402
"Kulti","West Bengal",3503,2076,0,5579,"817 ","210525 ",100.00,"210525 ",100.00,115834,94690,1,210525
"Barbani","West Bengal",3138,2420,0,5558,"909 ","202404 ",100.00,"202404 ",100.00,106001,96403,0,202404
"Dubrajpur","West Bengal",4477,2806,0,7283,"900 ","202699 ",100.00,"202699 ",100.00,106670,96029,0,202699
"Suri","West Bengal",4655,2951,0,7606,"937 ","222703 ",100.00,"222703 ",100.00,114974,107728,1,222703
"Bolpur","West Bengal",4488,2793,0,7281,"939 ","227471 ",100.00,"227471 ",100.00,117324,110145,2,227471
"Nanoor","West Bengal",4842,3149,0,7991,"939 ","239439 ",100.00,"239439 ",100.00,123479,115960,0,239439
"Labpur","West Bengal",4653,3234,0,7887,"929 ","207409 ",100.00,"207409 ",100.00,107499,99909,1,207409
"Sainthia","West Bengal",5023,3208,0,8231,"922 ","214580 ",100.00,"214580 ",100.00,111638,102941,1,214580
"Mayureswar","West Bengal",4855,3494,0,8349,"948 ","202882 ",100.00,"202882 ",100.00,104134,98748,0,202882
"Rampurhat","West Bengal",4505,3173,0,7678,"954 ","214134 ",100.00,"214134 ",100.00,109579,104554,1,214134
"Hansan","West Bengal",5338,4237,1,9576,"933 ","207725 ",100.00,"207725 ",100.00,107460,100264,1,207725
"Nalhati","West Bengal",5812,4261,2,10075,"931 ","205258 ",100.00,"205258 ",100.00,106306,98946,6,205258
"Murarai","West Bengal",5743,4810,0,10553,"951 ","222061 ",100.00,"222061 ",100.00,113811,108249,1,222061
"All India",,"9592389 ","4177 ","23161296 ","909.20 ","796010347 ","97.72 ","803489584 ","98.64 ","Above18 Years","387911330 ","28341 ","814591184 ",
